player,nation,position,squad,competition,age,born,90s,tackles,tackles_won,tackles_def 3rd,tackles_mid 3rd,tackles_att 3rd,dribblers_tackled,dribblers_challenged,dribblers_tackled%,challenges_lost,blocks,shotsblocked,passesblocked,interceptions,tkl+int,clearances,errors_leadingtoshot
Max Aarons,ENG,DF,Bournemouth,Premier League,24,2000,1,2,2,1,1,0,1,1,100,0,3,1,2,1,3,0,0
Max Aarons,ENG,"DF,MF",Valencia,La Liga,24,2000,1.3,4,4,2,2,0,4,5,80,1,1,0,1,0,4,3,0
Rodrigo Abajas,ESP,DF,Valencia,La Liga,21,2003,0.7,3,2,2,1,0,3,3,100,0,1,0,1,1,4,0,0
James Abankwah,IRL,"DF,MF",Udinese,Serie A,20,2004,1,4,2,4,0,0,2,3,66.7,1,2,1,1,1,5,3,0
Keyliane Abdallah,FRA,FW,Marseille,Ligue 1,18,2006,0,1,1,1,0,0,1,1,100,0,0,0,0,0,1,0,0
Yunis Abdelhamid,MAR,DF,Saint-Étienne,Ligue 1,36,1987,11.5,17,11,15,2,0,10,16,62.5,6,26,18,8,14,31,57,1
Himad Abdelli,ALG,"MF,FW",Angers,Ligue 1,24,1999,31.6,48,32,13,20,15,15,48,31.3,33,24,1,23,26,74,28,2
Mohamed Abdelmoneim,EGY,DF,Nice,Ligue 1,25,1999,9.5,21,14,12,6,3,13,22,59.1,9,11,5,6,15,36,56,1
Ali Abdi,TUN,"DF,MF",Nice,Ligue 1,30,1993,15.5,43,25,18,14,11,28,43,65.1,15,20,6,14,20,63,37,0
Saud Abdulhamid,KSA,DF,Roma,Serie A,25,1999,2.3,3,2,2,0,1,1,1,100,0,2,0,2,2,5,0,0
Abel,ESP,DF,Osasuna,La Liga,23,2000,23,61,37,28,25,8,39,63,61.9,24,29,4,25,18,79,64,2
Nabil Aberdin,FRA,MF,Getafe,La Liga,21,2002,2.9,6,4,3,3,0,1,1,100,0,3,0,3,0,6,5,0
Oliver Abildgaard,DEN,MF,Como,Serie A,28,1996,0.1,0,0,0,0,0,0,0,,0,1,0,1,0,0,0,0
Matthis Abline,FRA,FW,Nantes,Ligue 1,21,2003,30.8,11,5,2,4,5,3,9,33.3,6,15,1,14,4,15,36,1
Abner,BRA,DF,Lyon,Ligue 1,24,2000,12.1,29,20,12,10,7,21,32,65.6,11,15,2,13,5,34,41,0
Zakaria Aboukhlal,MAR,"MF,FW",Toulouse,Ligue 1,24,2000,21.1,22,13,7,8,7,4,23,17.4,19,16,1,15,6,28,9,0
Abdel Abqar,MAR,DF,Alavés,La Liga,25,1999,27.4,36,23,24,11,1,20,34,58.8,14,28,18,10,39,75,146,1
Tammy Abraham,ENG,FW,Roma,Serie A,26,1997,0,0,0,0,0,0,0,1,0,1,0,0,0,0,0,0,0
Tammy Abraham,ENG,FW,Milan,Serie A,26,1997,13.1,17,11,2,10,5,6,8,75,2,13,0,13,2,19,16,0
Federico Accornero,ITA,MF,Genoa,Serie A,20,2004,0.1,0,0,0,0,0,0,0,,0,0,0,0,0,0,0,0
Francesco Acerbi,ITA,DF,Inter,Serie A,36,1988,19,23,19,16,7,0,11,17,64.7,6,22,16,6,26,49,81,0
Joshua Acheampong,ENG,DF,Chelsea,Premier League,18,2006,1.9,2,1,2,0,0,2,2,100,0,1,0,1,1,3,2,0
Akor Adams,NGA,FW,Sevilla,La Liga,24,2000,1.5,0,0,0,0,0,0,0,,0,1,0,1,0,0,1,0
Akor Adams,NGA,FW,Montpellier,Ligue 1,24,2000,11.9,4,3,1,2,1,3,4,75,1,2,1,1,1,5,5,1
Che Adams,SCO,FW,Torino,Serie A,28,1996,29.5,12,6,2,4,6,1,7,14.3,6,13,6,7,2,14,18,0
Tyler Adams,USA,MF,Bournemouth,Premier League,25,1999,21.8,83,50,26,49,8,39,72,54.2,33,33,10,23,32,115,42,0
Junior Adamu,AUT,FW,Freiburg,Bundesliga,23,2001,17.2,9,3,3,3,3,3,11,27.3,8,14,0,14,12,21,20,0
Tosin Adarabioyo,ENG,DF,Chelsea,Premier League,26,1997,15.7,17,13,11,6,0,8,12,66.7,4,9,7,2,11,28,80,0
Martin Adeline,FRA,MF,Reims,Ligue 1,20,2003,0.3,1,1,0,1,0,1,2,50,1,0,0,0,0,1,2,0
Karim Adeyemi,GER,"FW,MF",Dortmund,Bundesliga,22,2002,15.9,20,14,6,6,8,8,20,40,12,14,1,13,7,27,5,0
Simon Adingra,CIV,"FW,MF",Brighton,Premier League,22,2002,12.2,23,14,10,8,5,10,26,38.5,16,12,0,12,8,31,6,2
Amine Adli,MAR,"MF,FW",Leverkusen,Bundesliga,24,2000,8.5,15,9,4,2,9,4,11,36.4,7,11,0,11,0,15,4,0
Yacine Adli,FRA,MF,Fiorentina,Serie A,24,2000,13.5,32,19,11,16,5,17,39,43.6,22,13,1,12,6,38,19,0
Adrián,ESP,GK,Betis,La Liga,37,1987,19,0,0,0,0,0,0,3,0,3,0,0,0,0,0,14,3
Adryelson,BRA,DF,Lyon,Ligue 1,26,1998,0,0,0,0,0,0,0,0,,0,0,0,0,1,1,1,0
Vasilije Adžić,MNE,"MF,FW",Juventus,Serie A,18,2006,0.5,2,2,0,1,1,0,1,0,1,0,0,0,0,2,0,0
Michel Aebischer,SUI,MF,Bologna,Serie A,27,1997,8,18,13,8,7,3,10,14,71.4,4,4,1,3,7,25,6,0
Oladapo Afolayan,ENG,"FW,MF",St. Pauli,Bundesliga,26,1998,18.2,17,8,4,8,5,7,19,36.8,12,17,1,16,8,25,20,0
Emmanuel Agbadou,CIV,DF,Wolves,Premier League,27,1997,15.7,30,19,21,9,0,13,20,65,7,19,13,6,12,42,90,0
Emmanuel Agbadou,CIV,DF,Reims,Ligue 1,27,1997,14,25,17,19,3,3,19,26,73.1,7,22,13,9,19,44,64,1
Asher Agbinone,ENG,MF,Crystal Palace,Premier League,18,2005,0.1,2,1,0,2,0,0,0,,0,0,0,0,0,2,0,0
Jeremy Agbonifo,SWE,"FW,MF",Lens,Ligue 1,18,2005,3.3,7,6,6,0,1,3,7,42.9,4,2,1,1,1,8,0,1
Julen Agirrezabala,ESP,GK,Athletic Club,La Liga,23,2000,13.4,0,0,0,0,0,0,1,0,1,0,0,0,0,0,4,0
Lucien Agoume,FRA,MF,Sevilla,La Liga,22,2002,23.5,70,32,23,37,10,27,39,69.2,12,30,11,19,41,111,42,0
Felix Agu,NGA,DF,Werder Bremen,Bundesliga,24,1999,19.5,30,14,12,14,4,12,23,52.2,11,27,9,18,21,51,48,0
Álvaro Aguado,ESP,MF,Espanyol,La Liga,28,1996,4.9,5,2,3,2,0,3,9,33.3,6,7,1,6,4,9,5,1
Lorenzo Aguado,ESP,DF,Real Madrid,La Liga,21,2002,0.1,0,0,0,0,0,0,0,,0,0,0,0,0,0,2,0
Nayef Aguerd,MAR,DF,Real Sociedad,La Liga,28,1996,19.6,30,24,17,12,1,12,18,66.7,6,21,15,6,13,43,91,0
Ruben Aguilar,FRA,"DF,MF",Lens,Ligue 1,31,1993,12.5,34,18,17,12,5,24,39,61.5,15,25,3,22,13,47,23,0
Naouirou Ahamada,FRA,"MF,FW",Rennes,Ligue 1,22,2002,0.6,0,0,0,0,0,0,0,,0,0,0,0,2,2,2,0
Honest Ahanor,ITA,"DF,MF",Genoa,Serie A,16,2008,3,7,5,2,3,2,7,10,70,3,4,0,4,1,8,9,0
Erik Ahlstrand,SWE,"FW,MF",St. Pauli,Bundesliga,22,2001,0.5,0,0,0,0,0,0,0,,0,1,0,1,1,1,1,0
Jean-Eudes Aholou,CIV,MF,Angers,Ligue 1,30,1994,21.8,56,36,26,20,10,22,48,45.8,26,34,14,20,33,89,32,0
Joseph Aidoo,GHA,DF,Valladolid,La Liga,28,1995,6.5,5,5,3,2,0,2,3,66.7,1,8,4,4,5,10,26,1
Joseph Aidoo,GHA,DF,Celta Vigo,La Liga,28,1995,0,1,0,1,0,0,0,0,,0,0,0,0,0,1,0,0
Ayman Aiki,FRA,"FW,MF",Saint-Étienne,Ligue 1,19,2005,1.4,3,3,1,2,0,1,1,100,0,1,0,1,1,4,0,0
Ola Aina,NGA,DF,Nott'ham Forest,Premier League,27,1996,33.3,55,42,39,15,1,36,64,56.3,28,34,12,22,33,88,115,4
Rayan Aït-Nouri,ALG,DF,Wolves,Premier League,23,2001,34.5,89,57,52,28,9,43,70,61.4,27,42,6,36,26,115,75,2
Junior Ajayi,CIV,FW,Hellas Verona,Serie A,19,2004,0.1,0,0,0,0,0,0,0,,0,0,0,0,0,0,0,0
Kristoffer Ajer,NOR,DF,Brentford,Premier League,26,1998,16,26,18,14,11,1,14,27,51.9,13,17,4,13,12,38,50,0
Ludovic Ajorque,FRA,FW,Brest,Ligue 1,30,1994,27.7,26,19,3,12,11,10,32,31.3,22,20,5,15,6,32,26,0
Manuel Akanji,SUI,DF,Manchester City,Premier League,29,1995,22.4,19,12,12,4,3,11,17,64.7,6,11,8,3,9,28,64,3
Ümit Akdag,ROU,DF,Toulouse,Ligue 1,20,2003,5.6,8,4,3,4,1,5,12,41.7,7,10,8,2,11,19,19,0
Nathan Aké,NED,DF,Manchester City,Premier League,29,1995,7.5,9,7,7,2,0,4,6,66.7,2,7,2,5,3,12,22,1
Ilias Akhomach,MAR,"MF,FW",Villarreal,La Liga,20,2004,6.5,12,7,4,4,4,6,12,50,6,8,0,8,3,15,13,0
Sergio Akieme,ESP,DF,Reims,Ligue 1,26,1997,28,34,23,30,3,1,22,36,61.1,14,26,9,17,17,51,97,4
Maghnes Akliouche,FRA,"FW,MF",Monaco,Ligue 1,22,2002,26.7,51,31,12,24,15,19,41,46.3,22,21,0,21,15,66,13,0
Paul Akouokou,CIV,MF,Lyon,Ligue 1,26,1997,0.2,1,0,0,1,0,0,0,,0,0,0,0,1,2,0,1
Clément Akpa,CIV,DF,Auxerre,Ligue 1,22,2001,27.6,55,34,36,12,7,31,46,67.4,15,38,14,24,42,97,141,2
Jean-Daniel Akpa-Akpro,CIV,MF,Monza,Serie A,31,1992,10.7,30,18,15,14,1,9,21,42.9,12,19,6,13,13,43,16,1
David Akpan Ankeye,NGA,"FW,MF",Genoa,Serie A,22,2002,0.5,0,0,0,0,0,0,1,0,1,0,0,0,0,0,1,0
Kevin Akpoguma,NGA,DF,Hoffenheim,Bundesliga,29,1995,24.7,54,27,36,12,6,30,46,65.2,16,65,37,28,29,83,115,1
Chuba Akpom,ENG,FW,Lille,Ligue 1,28,1995,7.1,8,5,0,4,4,2,6,33.3,4,9,0,9,0,8,3,0
David Alaba,AUT,DF,Real Madrid,La Liga,32,1992,3.5,1,0,1,0,0,0,0,,0,5,5,0,6,7,7,0
Ibrahim Alani,NGA,MF,Valladolid,La Liga,18,2006,1.8,12,7,8,4,0,4,6,66.7,2,3,1,2,1,13,1,0
Andreas Albers,DEN,FW,St. Pauli,Bundesliga,34,1990,0.7,1,1,0,0,1,0,1,0,1,0,0,0,0,1,1,0
Raúl Albiol,ESP,DF,Villarreal,La Liga,38,1985,13.2,10,9,9,1,0,6,10,60,4,10,9,1,6,16,69,1
Carlos Alcaraz,ARG,MF,Southampton,Premier League,21,2002,0.1,0,0,0,0,0,0,0,,0,0,0,0,1,1,0,0
Carlos Alcaraz,ARG,"FW,MF",Everton,Premier League,21,2002,8.5,11,5,5,3,3,3,11,27.3,8,9,2,7,5,16,10,0
Omar Alderete,PAR,DF,Getafe,La Liga,27,1996,33,43,29,30,11,2,20,30,66.7,10,38,22,16,40,83,241,1
Carles Aleñá,ESP,"MF,FW",Getafe,La Liga,26,1998,5,6,3,2,3,1,4,13,30.8,9,9,1,8,0,6,7,0
Carles Aleñá,ESP,"MF,FW",Alavés,La Liga,26,1998,12.1,19,12,6,7,6,7,17,41.2,10,11,0,11,2,21,4,0
Ben Alexander Voll,GER,GK,St. Pauli,Bundesliga,23,2000,1,0,0,0,0,0,0,0,,0,0,0,0,0,0,0,0
Trent Alexander-Arnold,ENG,DF,Liverpool,Premier League,25,1998,26.3,72,50,44,19,9,49,105,46.7,56,26,9,17,31,103,55,4
Alfon,ESP,"FW,MF",Celta Vigo,La Liga,25,1999,15.2,8,3,3,2,3,4,12,33.3,8,8,0,8,5,13,5,1
Mohamed Ali Cho,FRA,"FW,MF",Nice,Ligue 1,20,2004,18,13,9,4,5,4,4,12,33.3,8,17,1,16,5,18,8,0
Faride Alidou,GER,"FW,MF",Hellas Verona,Serie A,23,2001,0.8,0,0,0,0,0,0,0,,0,1,0,1,1,1,3,1
Alisson,BRA,GK,Liverpool,Premier League,31,1992,27.9,1,0,1,0,0,0,1,0,1,0,0,0,0,1,13,1
Tadeo Allende,ARG,FW,Celta Vigo,La Liga,25,1999,0,0,0,0,0,0,0,0,,0,0,0,0,0,0,0,0
Jim Allevinah,GAB,FW,Angers,Ligue 1,29,1995,19.4,19,11,6,9,4,5,28,17.9,23,10,0,10,12,31,17,0
Dele Alli,ENG,MF,Como,Serie A,28,1996,0.1,0,0,0,0,0,0,0,,0,0,0,0,0,0,0,0
Thiago Almada,ARG,"MF,FW",Lyon,Ligue 1,23,2001,10.6,14,8,7,5,2,7,21,33.3,14,2,0,2,7,21,6,3
Domingos André Ribeiro Almeida,POR,"MF,FW",Valencia,La Liga,24,2000,22,48,32,18,21,9,14,39,35.9,25,21,3,18,8,56,14,1
Iker Almena,ESP,"FW,DF",Girona,La Liga,20,2004,0.5,0,0,0,0,0,0,1,0,1,1,0,1,0,0,2,0
Miguel Almirón,PAR,FW,Newcastle Utd,Premier League,30,1994,1.7,3,2,2,0,1,2,3,66.7,1,2,0,2,0,3,0,0
Pontus Almqvist,SWE,"FW,MF",Parma,Serie A,25,1999,12.4,17,13,7,7,3,8,17,47.1,9,13,0,13,19,36,8,0
Marcos Alonso,ESP,DF,Celta Vigo,La Liga,33,1990,29.4,35,21,19,13,3,25,44,56.8,19,22,7,15,34,69,126,4
Giorgio Altare,ITA,DF,Venezia,Serie A,25,1998,8.4,13,12,8,3,2,8,15,53.3,7,21,11,10,17,30,49,0
Adrià Altimira,ESP,"DF,FW",Leganés,La Liga,23,2001,18.1,41,24,26,12,3,24,40,60,16,15,6,9,15,56,54,2
Sergi Altimira,ESP,MF,Betis,La Liga,22,2001,21.9,61,37,17,38,6,36,60,60,24,28,1,27,24,85,43,3
Olabade Aluko,,DF,Leicester City,Premier League,,,0,1,1,0,0,1,1,1,100,0,0,0,0,0,1,0,0
Edson Álvarez,MEX,MF,West Ham,Premier League,26,1997,19.7,50,27,27,15,8,17,35,48.6,18,23,8,15,18,68,46,1
Hugo Álvarez,ESP,"MF,DF",Celta Vigo,La Liga,21,2003,17.5,26,9,12,10,4,10,19,52.6,9,19,2,17,8,34,29,1
Julián Álvarez,ARG,FW,Atlético Madrid,La Liga,24,2000,27.9,25,17,5,11,9,8,30,26.7,22,14,0,14,2,27,12,1
Yeray Álvarez,ESP,DF,Athletic Club,La Liga,29,1995,19.8,25,13,14,9,2,15,22,68.2,7,10,6,4,34,59,129,1
Skelly Alvero,FRA,MF,Werder Bremen,Bundesliga,22,2002,2.6,11,6,5,5,1,4,5,80,1,4,0,4,2,13,10,0
Will Alves,ENG,FW,Leicester City,Premier League,19,2005,0,0,0,0,0,0,0,0,,0,0,0,0,0,0,0,0
Selim Amallah,MAR,MF,Valladolid,La Liga,27,1996,15.3,30,18,10,18,2,10,18,55.6,8,24,2,22,14,44,5,1
Harry Amass,ENG,DF,Manchester Utd,Premier League,17,2007,3.8,6,2,5,1,0,2,8,25,6,11,1,10,2,8,11,0
Amath,SEN,"FW,DF",Valladolid,La Liga,28,1996,4.2,2,0,2,0,0,1,8,12.5,7,7,1,6,2,4,6,0
Jordan Amavi,FRA,DF,Brest,Ligue 1,30,1994,8.8,24,17,10,11,3,15,21,71.4,6,10,2,8,7,31,18,0
Aurele Amenda,SUI,DF,Eint Frankfurt,Bundesliga,21,2003,1.1,1,0,1,0,0,0,0,,0,2,2,0,2,3,11,0
Kelvin Amian,FRA,DF,Nantes,Ligue 1,26,1998,24.1,55,31,40,14,1,29,35,82.9,6,18,11,7,13,68,85,0
Michael Amir Murillo,PAN,DF,Marseille,Ligue 1,28,1996,27.1,49,31,30,13,6,32,46,69.6,14,21,8,13,18,67,70,4
Nadiem Amiri,GER,MF,Mainz 05,Bundesliga,27,1996,27.5,50,23,13,28,9,19,46,41.3,27,19,4,15,16,66,30,2
Samuel Amo-Ameyaw,ENG,"FW,DF",Southampton,Premier League,18,2006,0.3,1,0,0,1,0,1,1,100,0,0,0,0,0,1,0,0
Samuel Amo-Ameyaw,ENG,"DF,MF",Strasbourg,Ligue 1,18,2006,3.6,5,3,3,2,0,2,9,22.2,7,3,0,3,3,8,2,0
Mathis Amougou,FRA,MF,Chelsea,Premier League,18,2006,0.1,0,0,0,0,0,0,0,,0,0,0,0,0,0,0,0
Mathis Amougou,FRA,MF,Saint-Étienne,Ligue 1,18,2006,9.5,21,15,15,5,1,10,19,52.6,9,10,0,10,12,33,4,0
Mohamed Amoura,ALG,FW,Wolfsburg,Bundesliga,24,2000,27.4,29,22,14,5,10,14,37,37.8,23,42,2,40,9,38,24,0
Sofyan Amrabat,MAR,MF,Fiorentina,Serie A,27,1996,2,3,2,1,2,0,2,2,100,0,1,1,0,0,3,2,0
Joachim Andersen,DEN,DF,Crystal Palace,Premier League,28,1996,1,1,1,1,0,0,1,2,50,1,0,0,0,0,1,7,0
Joachim Andersen,DEN,DF,Fulham,Premier League,28,1996,28.7,27,18,20,6,1,15,24,62.5,9,37,28,9,34,61,188,1
Elliot Anderson,ENG,MF,Nott'ham Forest,Premier League,21,2002,30.3,92,56,54,29,9,48,111,43.2,63,48,9,39,31,123,76,4
André,BRA,MF,Wolves,Premier League,23,2001,27.5,91,55,41,41,9,37,63,58.7,26,42,8,34,37,128,30,1
Benjamin André,FRA,MF,Lille,Ligue 1,33,1990,29.9,103,57,31,60,12,54,96,56.3,42,42,6,36,48,151,56,0
Marcos André,BRA,FW,Valladolid,La Liga,27,1996,13.2,10,6,3,5,2,5,13,38.5,8,18,2,16,3,13,10,0
Robert Andrich,GER,"MF,DF",Leverkusen,Bundesliga,29,1994,17.8,24,12,8,14,2,7,14,50,7,16,8,8,29,53,23,0
Angeliño,ESP,DF,Roma,Serie A,27,1997,35.3,46,24,20,24,2,17,34,50,17,33,9,24,28,74,98,0
Lorenzo Anghelè,ITA,FW,Juventus,Serie A,19,2005,0.1,0,0,0,0,0,0,0,,0,0,0,0,0,0,0,0
Faustino Anjorin,ENG,MF,Empoli,Serie A,22,2001,12.4,29,13,9,14,6,9,18,50,9,18,3,15,13,42,20,0
Waldemar Anton,GER,DF,Dortmund,Bundesliga,28,1996,21.7,34,21,18,10,6,17,23,73.9,6,33,16,17,30,64,112,1
Leandro Antonetti,PUR,FW,Sevilla,La Liga,21,2003,0.3,0,0,0,0,0,0,0,,0,0,0,0,0,0,0,0
Kyllian Antonio,FRA,"DF,MF",Lens,Ligue 1,16,2008,1.5,3,2,2,0,1,1,3,33.3,2,3,0,3,3,6,3,1
Michail Antonio,JAM,FW,West Ham,Premier League,34,1990,9.3,2,2,0,1,1,2,3,66.7,1,6,0,6,0,2,2,0
Antoniu,ESP,"FW,MF",Espanyol,La Liga,21,2002,11.4,21,10,9,8,4,9,21,42.9,12,14,2,12,8,29,11,1
Antony,BRA,"DF,MF",Manchester Utd,Premier League,24,2000,1.6,6,3,4,2,0,2,5,40,3,2,0,2,2,8,0,0
Antony,BRA,FW,Betis,La Liga,24,2000,15.1,25,11,6,9,10,8,22,36.4,14,12,1,11,10,35,9,1
Anuar,MAR,"MF,FW",Valladolid,La Liga,29,1995,19.1,38,27,21,12,5,15,28,53.6,13,24,8,16,18,56,26,1
Dennis Appiah,FRA,DF,Saint-Étienne,Ligue 1,32,1992,23.6,71,43,42,22,7,41,71,57.7,30,36,8,28,29,100,89,2
Aritz Arambarri,ESP,DF,Leganés,La Liga,26,1998,2,1,1,1,0,0,1,1,100,0,2,2,0,3,4,8,0
Mauro Arambarri,URU,MF,Getafe,La Liga,28,1995,29.6,48,29,10,33,5,22,48,45.8,26,35,6,29,15,63,46,0
Jon Aramburu,VEN,DF,Real Sociedad,La Liga,22,2002,27.3,102,70,61,30,11,66,100,66,34,40,8,32,30,132,98,0
Julian Araujo,MEX,DF,Bournemouth,Premier League,22,2001,5.5,10,5,4,6,0,5,12,41.7,7,3,0,3,6,16,18,0
Ronald Araújo,URU,DF,Barcelona,La Liga,25,1999,8.4,12,9,6,5,1,4,5,80,1,6,4,2,9,21,25,0
Cameron Archer,ENG,FW,Southampton,Premier League,23,2001,16,13,8,8,3,2,2,9,22.2,7,5,1,4,2,15,11,0
Carlens Arcus,HAI,DF,Angers,Ligue 1,28,1996,22.7,52,35,32,15,5,34,56,60.7,22,24,4,20,27,79,83,3
Alphonse Areola,FRA,GK,West Ham,Premier League,31,1993,25.1,2,2,2,0,0,2,3,66.7,1,0,0,0,0,2,15,3
Adu Ares,ESP,FW,Athletic Club,La Liga,22,2001,0.2,0,0,0,0,0,0,1,0,1,0,0,0,0,0,0,0
Jesús Areso,ESP,DF,Osasuna,La Liga,25,1999,34.2,53,38,31,14,8,39,56,69.6,17,26,4,22,8,61,92,0
David Argüelles,ESP,MF,Getafe,La Liga,22,2002,0.1,0,0,0,0,0,0,0,,0,2,0,2,0,0,0,0
Joe Aribo,NGA,"MF,DF",Southampton,Premier League,28,1996,22.4,47,33,17,24,6,17,35,48.6,18,28,11,17,20,67,32,3
Adam Armstrong,ENG,"FW,MF",Southampton,Premier League,27,1997,13.9,12,3,2,7,3,3,14,21.4,11,6,1,5,3,15,8,0
Harrison Armstrong,ENG,MF,Everton,Premier League,17,2007,0.5,0,0,0,0,0,0,1,0,1,0,0,0,0,0,1,0
José Arnaiz,ESP,"FW,MF",Osasuna,La Liga,29,1995,1.5,7,5,3,3,1,4,7,57.1,3,2,0,2,5,12,1,0
Hákon Arnar Haraldsson,ISL,"MF,FW",Lille,Ligue 1,21,2003,19.5,36,16,9,17,10,16,33,48.5,17,10,2,8,8,44,6,0
Marko Arnautović,AUT,FW,Inter,Serie A,35,1989,5.9,7,5,1,3,3,3,5,60,2,3,0,3,1,8,1,0
Maximilian Arnold,GER,MF,Wolfsburg,Bundesliga,30,1994,26.2,34,20,13,18,3,15,33,45.5,18,21,11,10,24,58,70,2
Jann-Fiete Arp,GER,"FW,MF",Holstein Kiel,Bundesliga,24,2000,7.9,13,10,5,2,6,4,13,30.8,9,6,0,6,3,16,8,1
Sergio Arribas,ESP,DF,Betis,La Liga,21,2003,1,7,4,4,3,0,6,7,85.7,1,2,2,0,3,10,4,0
Kepa Arrizabalaga,ESP,GK,Bournemouth,Premier League,29,1994,31,1,0,1,0,0,0,2,0,2,2,0,2,0,1,15,3
Arthur,BRA,DF,Leverkusen,Bundesliga,21,2003,8.4,14,11,3,9,2,5,10,50,5,8,0,8,9,23,29,0
Takuma Asano,JPN,"FW,MF",Mallorca,La Liga,29,1994,11.7,13,9,5,7,1,6,11,54.5,5,7,0,7,6,19,9,0
Raúl Asencio,ESP,DF,Real Madrid,La Liga,21,2003,18.6,22,16,18,4,0,10,13,76.9,3,11,6,5,16,38,88,2
Marco Asensio,ESP,MF,Aston Villa,Premier League,28,1996,8.3,7,5,0,7,0,3,9,33.3,6,7,1,6,2,9,3,0
Marco Asensio,ESP,"FW,MF",Paris S-G,Ligue 1,28,1996,6.9,4,3,1,3,0,0,6,0,6,1,0,1,0,4,1,0
Kristjan Asllani,ALB,MF,Inter,Serie A,22,2002,10.9,14,3,8,4,2,8,22,36.4,14,8,1,7,9,23,13,1
Iago Aspas,ESP,"FW,MF",Celta Vigo,La Liga,36,1987,19.4,13,8,4,5,4,8,20,40,12,18,1,17,8,21,5,0
Yaser Asprilla,COL,"FW,MF",Girona,La Liga,20,2003,15.6,22,12,6,8,8,8,23,34.8,15,14,0,14,7,29,7,1
Lorenz Assignon,TOG,"DF,MF",Rennes,Ligue 1,24,2000,26.2,49,27,25,22,2,19,43,44.2,24,20,3,17,25,74,74,0
Dehmaine Assoumani,FRA,"MF,FW",Nantes,Ligue 1,19,2005,1.1,6,3,0,4,2,4,5,80,1,1,0,1,1,7,4,0
Valentin Atangana Edoa,FRA,MF,Reims,Ligue 1,18,2005,31.7,69,50,32,30,7,28,38,73.7,10,31,15,16,37,106,64,0
Arthur Atta,FRA,"MF,FW",Udinese,Serie A,21,2003,13.9,20,12,9,10,1,10,15,66.7,5,9,5,4,7,27,15,1
Noah Atubolu,GER,GK,Freiburg,Bundesliga,22,2002,25.6,0,0,0,0,0,0,0,,0,0,0,0,0,0,13,4
Emil Audero,IDN,GK,Como,Serie A,27,1997,8,0,0,0,0,0,0,1,0,1,0,0,0,0,0,4,1
Tommaso Augello,ITA,DF,Cagliari,Serie A,29,1994,30.1,49,28,28,17,4,30,43,69.8,13,23,8,15,16,65,109,2
Carlos Augusto,BRA,DF,Inter,Serie A,25,1999,18.1,29,14,12,11,6,12,19,63.2,7,21,9,12,9,38,50,0
Yann Aurel Bisseck,GER,DF,Inter,Serie A,23,2000,17.3,17,11,11,4,2,11,16,68.8,5,23,12,11,17,34,64,1
Brandon Austin,ENG,GK,Tottenham,Premier League,25,1999,1,0,0,0,0,0,0,0,,0,0,0,0,0,0,1,0
Ezequiel Ávila,ARG,FW,Betis,La Liga,30,1994,7.5,8,3,2,2,4,4,10,40,6,4,0,4,2,10,8,0
Taiwo Awoniyi,NGA,FW,Nott'ham Forest,Premier League,26,1997,4.6,6,3,0,3,3,4,5,80,1,1,0,1,0,6,7,0
Yasin Ayari,SWE,MF,Brighton,Premier League,20,2003,21.8,59,32,15,31,13,26,56,46.4,30,24,6,18,20,79,26,0
Florian Ayé,FRA,FW,Auxerre,Ligue 1,27,1997,6.4,2,2,0,0,2,0,2,0,2,7,0,7,7,9,6,0
André Ayew,GHA,FW,Le Havre,Ligue 1,34,1989,16.1,18,10,3,7,8,7,13,53.8,6,9,2,7,3,21,21,1
Jordan Ayew,GHA,"FW,MF",Crystal Palace,Premier League,32,1991,0.2,1,0,0,0,1,0,0,,0,0,0,0,0,1,0,0
Jordan Ayew,GHA,"FW,MF",Leicester City,Premier League,32,1991,18.2,27,15,8,14,5,7,23,30.4,16,21,2,19,12,39,19,0
Neil El Aynaoui,FRA,MF,Lens,Ligue 1,23,2001,17.6,39,21,18,15,6,12,34,35.3,22,34,8,26,30,69,29,0
Ayman Azhil,MAR,MF,Dortmund,Bundesliga,23,2001,0.3,1,1,1,0,0,0,0,,0,0,0,0,0,1,0,0
Adam Aznou,MAR,DF,Valladolid,La Liga,18,2006,9.7,28,21,20,8,0,21,43,48.8,22,24,8,16,10,38,30,0
Adam Aznou,MAR,DF,Bayern Munich,Bundesliga,18,2006,0.2,0,0,0,0,0,0,0,,0,0,0,0,0,0,1,0
César Azpilicueta,ESP,DF,Atlético Madrid,La Liga,34,1989,9.7,25,14,12,9,4,17,23,73.9,6,10,2,8,5,30,32,0
Paulo Azzi,BRA,DF,Cagliari,Serie A,30,1994,4.7,11,9,3,6,2,5,9,55.6,4,5,2,3,5,16,11,0
Oussama El Azzouzi,MAR,MF,Bologna,Serie A,23,2001,0.2,0,0,0,0,0,0,0,,0,0,0,0,2,2,0,0
Papa Ba,ESP,MF,Girona,La Liga,19,2004,0.5,1,1,1,0,0,0,0,,0,1,0,1,0,1,1,0
Shavy Babicka,GAB,"MF,FW",Toulouse,Ligue 1,24,2000,13.2,21,12,6,11,4,10,21,47.6,11,14,0,14,3,24,4,3
Jacopo Bacci,ITA,MF,Empoli,Serie A,19,2005,0.3,1,0,1,0,0,1,1,100,0,0,0,0,1,2,1,0
Aliou Badara Baldé,GUI,"MF,FW",Bochum,Bundesliga,21,2002,1,1,1,1,0,0,0,0,,0,2,0,2,0,1,0,0
Loïc Bade,FRA,DF,Sevilla,La Liga,24,2000,29.8,47,27,37,10,0,23,31,74.2,8,22,13,9,29,76,162,2
Milan Badelj,CRO,MF,Genoa,Serie A,35,1989,16.4,29,16,14,10,5,15,35,42.9,20,19,7,12,20,49,43,0
Benoît Badiashile,FRA,DF,Chelsea,Premier League,23,2001,3.7,9,6,5,4,0,4,5,80,1,2,2,0,6,15,12,2
Alex Baena,ESP,"MF,FW",Villarreal,La Liga,23,2001,28.8,28,15,6,14,8,10,39,25.6,29,29,2,27,22,50,22,2
Juma Bah,SLE,DF,Valladolid,La Liga,18,2006,9.6,10,7,7,3,0,3,5,60,2,15,8,7,12,22,60,0
Juma Bah,SLE,DF,Lens,Ligue 1,18,2006,7.6,16,10,6,10,0,5,7,71.4,2,10,7,3,17,33,47,1
Leon Bailey,JAM,"FW,MF",Aston Villa,Premier League,26,1997,12.7,7,5,2,3,2,3,11,27.3,8,6,0,6,3,10,12,0
Eric Bailly,CIV,DF,Villarreal,La Liga,30,1994,6.9,12,4,6,6,0,3,4,75,1,12,6,6,6,18,29,0
Theo Bair,CAN,FW,Auxerre,Ligue 1,24,1999,10.4,4,3,1,2,1,0,2,0,2,6,2,4,3,7,10,0
Stefan Bajcetic,ESP,"MF,DF",Las Palmas,La Liga,19,2004,10.8,29,14,13,13,3,12,28,42.9,16,25,4,21,15,44,26,1
Cédric Bakambu,COD,FW,Betis,La Liga,33,1991,7.9,6,4,0,5,1,3,7,42.9,4,13,2,11,0,6,5,0
Mitchel Bakker,NED,MF,Atalanta,Serie A,24,2000,0.2,1,0,1,0,0,1,1,100,0,0,0,0,0,1,0,0
Mitchel Bakker,NED,"FW,DF",Lille,Ligue 1,24,2000,12.7,23,13,6,11,6,10,19,52.6,9,10,1,9,12,35,15,0
Darryl Bakola,FRA,"DF,MF",Marseille,Ligue 1,16,2007,0.2,1,1,0,1,0,0,0,,0,0,0,0,0,1,0,0
Ridle Baku,GER,"FW,MF",Wolfsburg,Bundesliga,26,1998,13,23,15,9,9,5,8,19,42.1,11,22,1,21,15,38,15,0
Ridle Baku,GER,"DF,MF",RB Leipzig,Bundesliga,26,1998,14.2,24,19,9,13,2,9,23,39.1,14,18,2,16,9,33,45,0
Dilane Bakwa,FRA,"MF,DF",Strasbourg,Ligue 1,21,2002,27.7,26,14,11,8,7,12,24,50,12,21,1,20,15,41,27,0
Tommaso Baldanzi,ITA,"MF,FW",Roma,Serie A,21,2003,9.2,12,4,5,4,3,4,12,33.3,8,4,0,4,6,18,8,0
Alejandro Balde,ESP,DF,Barcelona,La Liga,20,2003,25.4,18,10,10,5,3,11,17,64.7,6,24,5,19,5,23,27,0
Keita Baldé,SEN,FW,Monza,Serie A,29,1995,7.1,1,1,0,1,0,1,2,50,1,4,0,4,2,3,0,0
Carlos Baleba,CMR,MF,Brighton,Premier League,20,2004,29.6,79,46,26,37,16,48,80,60,32,47,11,36,46,125,44,1
Leonardo Balerdi,ARG,DF,Marseille,Ligue 1,25,1999,25.3,54,39,32,17,5,27,47,57.4,20,25,14,11,38,92,72,4
Iván Balliu,ALB,DF,Rayo Vallecano,La Liga,32,1992,13.3,17,14,8,5,4,6,18,33.3,12,16,4,12,13,30,39,0
Fodé Ballo-Touré,SEN,"DF,MF",Le Havre,Ligue 1,27,1997,6.5,8,7,3,4,1,5,9,55.6,4,8,3,5,4,12,27,0
Botond Balogh,HUN,DF,Parma,Serie A,22,2002,22.8,36,16,22,13,1,20,28,71.4,8,34,26,8,25,61,141,2
Folarin Balogun,USA,FW,Monaco,Ligue 1,23,2001,6.8,1,1,0,0,1,0,4,0,4,0,0,0,1,2,0,0
Mario Balotelli,ITA,"FW,MF",Genoa,Serie A,33,1990,0.7,0,0,0,0,0,0,0,,0,0,0,0,0,0,1,0
Abdoulaye Bamba,CIV,DF,Angers,Ligue 1,34,1990,16.8,22,12,17,4,1,14,19,73.7,5,14,8,6,19,41,79,0
Jonathan Bamba,CIV,"FW,MF",Celta Vigo,La Liga,28,1996,9,12,7,4,6,2,5,12,41.7,7,6,0,6,5,17,6,0
Mohamed Bamba,CIV,MF,Reims,Ligue 1,19,2004,0.1,0,0,0,0,0,0,1,0,1,2,1,1,0,0,1,0
Samuel Bamba,GER,"FW,MF",Bochum,Bundesliga,20,2004,0.3,1,1,1,0,0,0,0,,0,0,0,0,0,1,0,0
Lameck Banda,ZAM,"FW,MF",Lecce,Serie A,23,2001,6.8,8,5,4,2,2,3,12,25,9,7,0,7,2,10,8,1
Daniel Bandeira,POR,MF,Hellas Verona,Serie A,24,2000,4.5,4,0,1,3,0,3,6,50,3,2,1,1,6,10,8,0
Mattia Bani,ITA,DF,Genoa,Serie A,30,1993,16.7,19,10,11,6,2,7,11,63.6,4,13,8,5,22,41,85,2
Noahkai Banks,USA,DF,Augsburg,Bundesliga,17,2006,3.1,11,5,6,4,1,3,7,42.9,4,4,1,3,5,16,28,0
Scott Banks,SCO,"FW,MF",St. Pauli,Bundesliga,22,2001,1.3,1,1,1,0,0,0,2,0,2,0,0,0,2,3,2,0
Adrian Baquerin,ESP,FW,Valladolid,La Liga,17,2007,0.5,1,1,0,1,0,0,0,,0,0,0,0,0,1,1,0
Antonín Barák,CZE,MF,Fiorentina,Serie A,29,1994,0.6,2,0,0,2,0,0,2,0,2,1,1,0,0,2,0,0
Federico Barba,ITA,DF,Como,Serie A,30,1993,4.8,2,2,1,1,0,1,4,25,3,2,2,0,4,6,15,0
Valentín Barco,ARG,"DF,FW",Sevilla,La Liga,20,2004,3.2,15,9,8,3,4,12,15,80,3,0,0,0,2,17,5,0
Valentín Barco,ARG,"MF,DF",Strasbourg,Ligue 1,20,2004,12.9,36,22,24,10,2,22,30,73.3,8,8,3,5,13,49,28,1
Bradley Barcola,FRA,FW,Paris S-G,Ligue 1,21,2002,24.2,27,17,10,8,9,8,31,25.8,23,25,2,23,19,46,12,0
Melvin Bard,FRA,"DF,MF",Nice,Ligue 1,23,2000,21.5,53,36,35,13,5,24,42,57.1,18,38,13,25,29,82,60,3
Nicolò Barella,ITA,MF,Inter,Serie A,27,1997,27.3,50,31,19,20,11,26,59,44.1,33,26,3,23,12,62,16,1
Gabriel Bares,SUI,"MF,DF",Montpellier,Ligue 1,23,2000,0.6,2,2,2,0,0,1,2,50,1,0,0,0,1,3,3,0
Borna Barišić,CRO,DF,Leganés,La Liga,31,1992,0.1,0,0,0,0,0,0,0,,0,0,0,0,0,0,0,0
Téo Barisic,FRA,DF,Lyon,Ligue 1,19,2004,0,0,0,0,0,0,0,0,,0,0,0,0,0,0,1,0
Kike Barja,ESP,"FW,MF",Osasuna,La Liga,27,1997,3.5,5,4,1,3,1,2,4,50,2,5,0,5,3,8,4,0
Ross Barkley,ENG,MF,Aston Villa,Premier League,30,1993,6.5,14,3,4,10,0,9,14,64.3,5,9,3,6,10,24,5,0
Aymen Barkok,MAR,MF,Mainz 05,Bundesliga,26,1998,0.8,2,1,1,1,0,1,1,100,0,1,1,0,2,4,0,0
Harvey Barnes,ENG,FW,Newcastle Utd,Premier League,26,1997,19.5,16,9,4,6,6,3,11,27.3,8,8,2,6,6,22,15,1
Enzo Barrenechea,ARG,MF,Valencia,La Liga,23,2001,24.3,57,30,22,29,6,32,46,69.6,14,30,8,22,28,85,48,1
Ander Barrenetxea,ESP,"MF,FW",Real Sociedad,La Liga,22,2001,14,26,19,7,14,5,6,23,26.1,17,15,0,15,11,37,16,1
Pablo Barrios,ESP,MF,Atlético Madrid,La Liga,21,2003,25.9,46,26,23,20,3,23,47,48.9,24,18,5,13,34,80,33,9
Thierno Barry,FRA,FW,Villarreal,La Liga,21,2002,25.8,11,8,2,5,4,4,10,40,6,15,2,13,0,11,19,0
Davide Bartesaghi,ITA,DF,Milan,Serie A,18,2005,1.3,4,2,1,1,2,4,4,100,0,1,1,0,3,7,1,0
Marc Bartra,ESP,DF,Betis,La Liga,33,1991,23.3,33,19,20,13,0,15,26,57.7,11,41,25,16,33,66,148,0
Federico Baschirotto,ITA,DF,Lecce,Serie A,27,1996,38,37,25,30,5,2,22,28,78.6,6,44,32,12,23,60,237,2
Daniele Baselli,ITA,MF,Como,Serie A,32,1992,0.2,0,0,0,0,0,0,0,,0,0,0,0,1,1,1,0
Calvin Bassey,NGA,DF,Fulham,Premier League,24,1999,34.2,54,34,35,19,0,22,31,71,9,40,17,23,20,74,118,8
Aboubacar Bassinga,CIV,MF,Las Palmas,La Liga,19,2005,0,0,0,0,0,0,0,0,,0,0,0,0,0,0,0,0
Alessandro Bastoni,ITA,DF,Inter,Serie A,25,1999,25.9,46,23,26,14,6,20,30,66.7,10,25,13,12,21,67,52,1
Augusto Batalla,ARG,GK,Rayo Vallecano,La Liga,28,1996,32,4,2,4,0,0,4,6,66.7,2,0,0,0,0,4,15,4
Michy Batshuayi,BEL,FW,Eint Frankfurt,Bundesliga,30,1993,3.3,1,1,1,0,0,1,1,100,0,2,0,2,1,2,0,0
Dylan Batubinsika,COD,DF,Saint-Étienne,Ligue 1,28,1996,22.4,26,13,19,6,1,13,22,59.1,9,23,14,9,39,65,140,3
Maximilian Bauer,GER,DF,Augsburg,Bundesliga,24,2000,7.3,14,8,5,7,2,9,14,64.3,5,10,4,6,6,20,35,1
Oliver Baumann,GER,GK,Hoffenheim,Bundesliga,34,1990,28,2,2,2,0,0,2,4,50,2,0,0,0,0,2,15,2
Christoph Baumgartner,AUT,MF,RB Leipzig,Bundesliga,24,1999,17.9,44,28,13,19,12,17,42,40.5,25,45,9,36,12,56,24,2
Rafael Bauza,ESP,MF,Espanyol,La Liga,19,2005,2,5,3,3,1,1,4,7,57.1,3,3,1,2,0,5,5,0
Altay Bayındır,TUR,GK,Manchester Utd,Premier League,26,1998,4,0,0,0,0,0,0,1,0,1,0,0,0,0,0,9,1
Ihlas Bebou,TOG,MF,Hoffenheim,Bundesliga,30,1994,0.1,0,0,0,0,0,0,0,,0,0,0,0,0,0,0,0
Adrian Beck,GER,"MF,FW",Heidenheim,Bundesliga,27,1997,17.8,36,17,18,12,6,12,35,34.3,23,31,2,29,9,45,17,0
Sheraldo Becker,SUR,"FW,MF",Real Sociedad,La Liga,29,1995,11.1,3,2,0,3,0,0,2,0,2,4,0,4,1,4,10,0
Timo Becker,GER,DF,Holstein Kiel,Bundesliga,27,1997,27.2,53,33,39,9,5,34,46,73.9,12,30,17,13,17,70,110,1
Jan Bednarek,POL,DF,Southampton,Premier League,28,1996,28.1,36,19,23,13,0,16,31,51.6,15,47,36,11,56,92,190,5
Donny van de Beek,NED,MF,Girona,La Liga,27,1997,15.8,29,18,17,7,5,13,26,50,13,19,3,16,10,39,12,0
Hannes Behrens,GER,DF,Hoffenheim,Bundesliga,,,0.3,1,1,0,1,0,0,0,,0,1,0,1,2,3,0,0
Kevin Behrens,GER,FW,Wolfsburg,Bundesliga,33,1991,1.9,1,1,0,1,0,0,1,0,1,0,0,0,1,2,2,0
Maximilian Beier,GER,"FW,MF",Dortmund,Bundesliga,21,2002,17.7,25,16,8,11,6,12,31,38.7,19,15,1,14,7,32,14,1
Luken Beitia,ESP,DF,Real Sociedad,La Liga,20,2004,0.1,1,1,1,0,0,1,1,100,0,0,0,0,0,1,2,0
Ismael Bekhoucha,MAR,"MF,DF",Getafe,La Liga,19,2004,0.8,1,1,1,0,0,1,2,50,1,2,1,1,2,3,2,0
Reda Belahyane,MAR,MF,Hellas Verona,Serie A,20,2004,18.4,36,26,16,13,7,13,17,76.5,4,20,9,11,10,46,22,1
Reda Belahyane,MAR,MF,Lazio,Serie A,20,2004,2.2,8,6,8,0,0,6,6,100,0,3,2,1,1,9,5,0
Haris Belkebla,ALG,MF,Angers,Ligue 1,30,1994,19.9,56,38,38,15,3,26,45,57.8,19,30,9,21,35,91,46,1
Yassin Belkhdim,FRA,MF,Angers,Ligue 1,22,2002,16.9,53,27,26,21,6,27,58,46.6,31,23,6,17,21,74,41,1
Stefan Bell,GER,DF,Mainz 05,Bundesliga,32,1991,16,22,12,16,6,0,9,14,64.3,5,16,14,2,28,50,107,1
Armel Bella Kotchap,GER,DF,Southampton,Premier League,22,2001,3.7,7,5,5,2,0,3,6,50,3,2,2,0,5,12,21,1
Raoul Bellanova,ITA,DF,Torino,Serie A,24,2000,1,0,0,0,0,0,0,1,0,1,0,0,0,0,0,4,0
Raoul Bellanova,ITA,DF,Atalanta,Serie A,24,2000,26.7,24,14,8,13,3,13,21,61.9,8,12,3,9,18,42,45,0
Jean-Ricner Bellegarde,FRA,"MF,FW",Wolves,Premier League,26,1998,18.6,39,24,17,19,3,14,20,70,6,19,3,16,10,49,18,1
Héctor Bellerín,ESP,DF,Betis,La Liga,29,1995,6.4,13,7,7,4,2,10,17,58.8,7,5,3,2,6,19,21,0
Jude Bellingham,ENG,MF,Real Madrid,La Liga,21,2003,27.6,61,33,20,27,14,28,42,66.7,14,37,2,35,28,89,23,1
Jeanuël Belocian,FRA,"DF,MF",Leverkusen,Bundesliga,19,2005,0.8,1,1,1,0,0,1,1,100,0,0,0,0,0,1,2,0
Andrea Belotti,ITA,FW,Como,Serie A,30,1993,6.6,7,5,1,4,2,1,4,25,3,4,0,4,1,8,8,0
Fran Beltrán,ESP,MF,Celta Vigo,La Liga,25,1999,26.9,50,35,24,21,5,24,56,42.9,32,26,6,20,26,76,34,4
Lucas Beltrán,ARG,"FW,MF",Fiorentina,Serie A,23,2001,20.7,23,10,10,7,6,7,21,33.3,14,15,2,13,5,28,14,0
Eliesse Ben Seghir,MAR,"MF,FW",Monaco,Ligue 1,19,2005,19.4,31,22,12,12,7,18,32,56.3,14,20,0,20,13,44,4,0
Carlos Benavídez,URU,MF,Alavés,La Liga,26,1998,5.4,19,14,10,6,3,6,11,54.5,5,5,2,3,8,27,14,1
Adrian Benedyczak,POL,"FW,MF",Parma,Serie A,23,2000,2.4,0,0,0,0,0,0,1,0,1,3,1,2,0,0,8,0
László Bénes,SVK,"MF,FW",Union Berlin,Bundesliga,26,1997,6.5,2,2,1,1,0,1,3,33.3,2,5,1,4,3,5,9,0
Iker Benito,ESP,"FW,MF",Osasuna,La Liga,21,2002,0.4,0,0,0,0,0,0,1,0,1,0,0,0,1,1,2,0
Ismaël Bennacer,ALG,MF,Milan,Serie A,26,1997,3.3,5,4,1,3,1,1,7,14.3,6,5,3,2,3,8,1,0
Ismaël Bennacer,ALG,MF,Marseille,Ligue 1,26,1997,7.2,21,10,8,12,1,12,18,66.7,6,6,0,6,10,31,2,1
Saïd Benrahma,ALG,"FW,MF",Lyon,Ligue 1,28,1995,8.2,9,5,4,4,1,3,10,30,7,6,0,6,3,12,2,0
Ramy Bensebaini,ALG,DF,Dortmund,Bundesliga,29,1995,22.5,51,25,25,18,8,33,51,64.7,18,42,9,33,33,84,86,1
Nabil Bentaleb,ALG,MF,Lille,Ligue 1,29,1994,3.7,4,3,2,0,2,3,7,42.9,4,5,0,5,5,9,7,2
Rodrigo Bentancur,URU,MF,Tottenham,Premier League,27,1997,18.3,40,22,19,17,4,19,40,47.5,21,25,8,17,40,80,38,1
Daniel Bentley,ENG,GK,Wolves,Premier League,31,1993,2,0,0,0,0,0,0,0,,0,0,0,0,0,0,1,0
Lucas Beraldo,BRA,DF,Paris S-G,Ligue 1,20,2003,22.3,38,31,30,8,0,23,37,62.2,14,16,8,8,21,59,63,3
Yuri Berchiche,ESP,DF,Athletic Club,La Liga,34,1990,22.7,33,21,19,11,3,19,33,57.6,14,25,5,20,27,60,72,3
Álex Berenguer,ESP,"FW,MF",Athletic Club,La Liga,29,1995,26,32,16,6,16,10,14,31,45.2,17,23,2,21,10,42,18,0
Sander Berge,NOR,MF,Fulham,Premier League,26,1998,24.7,50,30,23,23,4,27,39,69.2,12,27,8,19,21,71,38,1
Lucas Bergvall,SWE,MF,Tottenham,Premier League,18,2006,13.5,39,19,14,20,5,17,32,53.1,15,18,8,10,24,63,22,3
Medon Berisha,ALB,MF,Lecce,Serie A,20,2003,8,12,8,7,3,2,4,8,50,4,6,0,6,11,23,5,2
Mergim Berisha,GER,"FW,MF",Hoffenheim,Bundesliga,26,1998,3.7,3,3,1,2,0,0,3,0,3,2,1,1,0,3,3,0
Mergim Berisha,GER,FW,Augsburg,Bundesliga,26,1998,0.4,1,0,0,1,0,1,1,100,0,2,1,1,0,1,0,0
Adrian Bernabe,ESP,MF,Parma,Serie A,23,2001,16.1,29,18,16,9,4,14,32,43.8,18,22,9,13,7,36,26,1
Marc Bernal,ESP,MF,Barcelona,La Liga,17,2007,2.7,8,6,2,5,1,7,8,87.5,1,5,1,4,1,9,4,0
Bernardo,BRA,DF,Bochum,Bundesliga,29,1995,19.8,46,28,32,13,1,27,37,73,10,38,17,21,26,72,103,4
Juan Bernat,ESP,"DF,MF",Villarreal,La Liga,31,1993,2.4,9,7,7,1,1,4,5,80,1,3,1,2,1,10,4,0
Juan Bernat,ESP,"MF,DF",Getafe,La Liga,31,1993,7.8,19,13,9,5,5,7,12,58.3,5,9,3,6,2,21,12,0
Maxime Bernauer,FRA,DF,Saint-Étienne,Ligue 1,26,1998,8.5,9,9,5,2,2,5,8,62.5,3,7,3,4,5,14,44,1
Antoine Bernede,FRA,MF,Hellas Verona,Serie A,25,1999,6.6,15,8,4,9,2,10,16,62.5,6,6,1,5,5,20,3,0
Alexander Bernhardsson,SWE,"FW,MF",Holstein Kiel,Bundesliga,25,1998,14,29,15,9,9,11,20,31,64.5,11,14,0,14,5,34,25,0
Victor Bernth Kristiansen,DEN,DF,Leicester City,Premier League,21,2002,27.6,87,51,56,26,5,49,91,53.8,42,38,15,23,42,129,75,3
Matúš Bero,SVK,MF,Bochum,Bundesliga,28,1995,28.5,65,35,33,21,11,29,60,48.3,31,37,9,28,17,82,35,1
Juan Berrocal,ESP,DF,Getafe,La Liga,25,1999,11.8,14,7,10,4,0,10,14,71.4,4,6,3,3,15,29,59,0
Dimitry Bertaud,COD,GK,Montpellier,Ligue 1,26,1998,4,0,0,0,0,0,0,0,,0,0,0,0,0,0,2,0
Jan-Niklas Beste,GER,"FW,MF",Freiburg,Bundesliga,25,1999,2.4,2,1,0,1,1,1,7,14.3,6,3,0,3,1,3,7,0
Beto,GNB,FW,Everton,Premier League,26,1998,17,14,6,2,8,4,5,8,62.5,3,12,2,10,4,18,24,1
Sam Beukema,NED,DF,Bologna,Serie A,25,1998,33.5,54,29,27,24,3,22,41,53.7,19,36,21,15,30,84,111,0
Alessandro Bianco,ITA,MF,Monza,Serie A,21,2002,28.9,51,28,26,17,8,27,41,65.9,14,40,14,26,22,73,53,4
Alessandro Bianco,ITA,MF,Fiorentina,Serie A,21,2002,0.2,0,0,0,0,0,0,1,0,1,0,0,0,0,0,0,0
Mika Biereth,DEN,FW,Monaco,Ligue 1,21,2003,13.6,5,5,0,3,2,3,7,42.9,4,11,0,11,4,9,7,0
Jaka Bijol,SVN,DF,Udinese,Serie A,25,1999,32.9,43,25,32,10,1,21,40,52.5,19,38,18,20,38,81,182,1
El Bilal Touré,MLI,"FW,MF",Stuttgart,Bundesliga,22,2001,4,4,1,1,1,2,3,3,100,0,1,0,1,0,4,1,0
Philip Billing,DEN,MF,Bournemouth,Premier League,28,1996,2,14,5,7,6,1,3,4,75,1,3,0,3,5,19,2,0
Philip Billing,DEN,MF,Napoli,Serie A,28,1996,2.2,9,6,4,4,1,1,4,25,3,4,1,3,4,13,6,0
Cristiano Biraghi,ITA,DF,Torino,Serie A,31,1992,12.9,16,10,9,3,4,11,18,61.1,7,15,4,11,8,24,44,0
Cristiano Biraghi,ITA,DF,Fiorentina,Serie A,31,1992,4.8,4,4,1,3,0,2,7,28.6,5,2,0,2,4,8,11,0
Samuele Birindelli,ITA,"DF,MF",Monza,Serie A,25,1999,16.3,22,15,13,4,5,6,14,42.9,8,15,2,13,10,32,34,2
Tom Bischof,GER,"MF,FW",Hoffenheim,Bundesliga,19,2005,28.4,95,53,36,45,14,40,77,51.9,37,66,11,55,30,125,53,1
Yves Bissouma,MLI,MF,Tottenham,Premier League,27,1996,15.6,49,31,20,25,4,19,34,55.9,15,11,6,5,18,67,40,4
Leonardo Bittencourt,GER,MF,Werder Bremen,Bundesliga,30,1993,10.9,25,9,15,7,3,6,18,33.3,12,8,0,8,15,40,11,0
Emmanuel Biumla,FRA,DF,Angers,Ligue 1,19,2005,14.8,19,12,14,5,0,12,18,66.7,6,18,8,10,8,27,84,1
Marco Bizot,NED,GK,Brest,Ligue 1,33,1991,32,2,1,2,0,0,1,2,50,1,0,0,0,0,2,33,0
Bjarki Bjarkason,ISL,"DF,MF",Venezia,Serie A,24,2000,1.8,3,2,2,1,0,1,2,50,1,1,0,1,2,5,4,0
Antonio Blanco,ESP,MF,Alavés,La Liga,24,2000,30.3,67,40,23,37,7,32,83,38.6,51,30,7,23,42,109,48,1
Ludovic Blas,FRA,"MF,FW",Rennes,Ligue 1,26,1997,25.5,38,25,9,12,17,23,42,54.8,19,16,2,14,13,51,11,0
Daley Blind,NED,DF,Girona,La Liga,34,1990,30.9,49,27,26,19,4,31,48,64.6,17,32,9,23,32,81,94,2
Myron Boadu,NED,FW,Bochum,Bundesliga,23,2001,11.6,2,1,0,0,2,1,5,20,4,3,0,3,1,3,4,0
Augustine Boakye,GHA,"FW,MF",Saint-Étienne,Ligue 1,23,2000,8.1,7,3,3,4,0,3,11,27.3,8,5,0,5,6,13,4,0
Oscar Bobb,NOR,FW,Manchester City,Premier League,21,2003,0.2,0,0,0,0,0,0,0,,0,0,0,0,0,0,0,0
Mathéo Bodmer,FRA,MF,Le Havre,Ligue 1,20,2004,0.1,0,0,0,0,0,0,0,,0,0,0,0,0,0,1,0
Sacha Boey,FRA,DF,Bayern Munich,Bundesliga,23,2000,6.6,20,5,6,6,8,13,18,72.2,5,6,0,6,2,22,14,0
Jeremie Boga,CIV,"MF,FW",Nice,Ligue 1,27,1997,11.7,10,5,2,5,3,4,8,50,4,13,0,13,3,13,2,1
Lamare Bogarde,NED,"DF,MF",Aston Villa,Premier League,20,2004,5.3,14,6,6,6,2,10,16,62.5,6,5,3,2,1,15,13,0
Emil Bohinen,NOR,MF,Genoa,Serie A,25,1999,1.8,4,4,3,0,1,2,5,40,3,2,0,2,1,5,6,0
Adama Boiro,ESP,"DF,FW",Athletic Club,La Liga,22,2002,12.2,20,11,11,7,2,10,15,66.7,5,10,3,7,12,32,27,1
Willy Boly,CIV,DF,Nott'ham Forest,Premier League,33,1991,1.7,6,1,5,1,0,4,4,100,0,4,2,2,3,9,12,0
Moïse Bombito,CAN,DF,Nice,Ligue 1,24,2000,24.4,37,25,22,12,3,24,35,68.6,11,35,19,16,18,55,121,7
Warren Bondo,FRA,MF,Monza,Serie A,20,2003,18,35,24,19,12,4,13,19,68.4,6,16,6,10,5,40,8,4
Warren Bondo,FRA,MF,Milan,Serie A,20,2003,1.8,5,3,4,1,0,3,3,100,0,1,0,1,0,5,2,0
Victor Boniface,NGA,FW,Leverkusen,Bundesliga,23,2000,11.2,5,4,0,3,2,3,4,75,1,1,0,1,0,5,5,0
Kevin Bonifazi,ITA,DF,Lecce,Serie A,28,1996,0.7,1,1,1,0,0,1,1,100,0,1,1,0,2,3,3,0
Ange-Yoan Bonny,FRA,FW,Parma,Serie A,20,2003,28.1,34,16,4,23,7,8,14,57.1,6,17,2,15,3,37,17,0
Sebastiaan Bornauw,BEL,DF,Wolfsburg,Bundesliga,25,1999,8.8,9,6,4,4,1,4,8,50,4,14,12,2,12,21,36,0
Sven Botman,NED,DF,Newcastle Utd,Premier League,24,2000,4.6,12,9,6,5,1,7,9,77.8,2,5,4,1,5,17,25,1
Saïmon Bouabré,FRA,"MF,FW",Monaco,Ligue 1,18,2006,1.1,1,0,0,1,0,0,3,0,3,1,0,1,0,1,0,0
Ayyoub Bouaddi,FRA,MF,Lille,Ligue 1,16,2007,12.8,50,31,21,21,8,19,32,59.4,13,12,3,9,10,60,12,1
Badredine Bouanani,ALG,"MF,FW",Nice,Ligue 1,19,2004,12.2,11,4,4,4,3,6,18,33.3,12,16,3,13,11,22,4,0
Benjamin Bouchouari,MAR,MF,Saint-Étienne,Ligue 1,22,2001,19.7,33,27,15,13,5,16,46,34.8,30,21,1,20,17,50,15,2
Hicham Boudaoui,ALG,MF,Nice,Ligue 1,24,1999,27.1,76,52,28,37,11,31,53,58.5,22,40,11,29,22,98,45,1
Carlo Boukhalfa,MAR,MF,St. Pauli,Bundesliga,25,1999,18.3,26,11,7,17,2,7,19,36.8,12,22,3,19,12,38,25,1
Justin Bourgault,FRA,DF,Brest,Ligue 1,18,2005,1.4,2,1,1,1,0,0,0,,0,0,0,0,0,2,1,0
Benjamin Bourigeaud,FRA,MF,Rennes,Ligue 1,30,1994,0.9,1,0,0,1,0,0,2,0,2,2,1,1,2,3,1,0
Edoardo Bove,ITA,"MF,FW",Fiorentina,Serie A,22,2002,9.3,24,17,7,14,3,14,28,50,14,12,0,12,6,30,8,0
Jarrod Bowen,ENG,"FW,MF",West Ham,Premier League,27,1996,33,41,26,13,12,16,19,40,47.5,21,22,4,18,16,57,25,0
Enzo Boyomo,CMR,DF,Osasuna,La Liga,22,2001,33.2,68,43,46,18,4,30,39,76.9,9,34,19,15,44,112,137,3
Enzo Boyomo,CMR,DF,Valladolid,La Liga,22,2001,3,6,2,4,2,0,3,3,100,0,4,3,1,1,7,7,0
Domagoj Bradarić,CRO,DF,Hellas Verona,Serie A,24,1999,21.5,36,28,21,11,4,18,29,62.1,11,17,4,13,15,51,49,1
Conor Bradley,NIR,DF,Liverpool,Premier League,21,2003,8.4,14,10,7,5,2,11,22,50,11,9,2,7,4,18,31,0
Bilal Brahimi,ALG,MF,Nice,Ligue 1,24,2000,0.8,0,0,0,0,0,0,0,,0,1,0,1,0,0,2,0
Julian Brandt,GER,MF,Dortmund,Bundesliga,28,1996,25.6,26,11,13,8,5,15,43,34.9,28,17,0,17,14,40,13,1
Jarrad Branthwaite,ENG,DF,Everton,Premier League,22,2002,27.9,36,20,26,10,0,20,28,71.4,8,31,23,8,27,63,191,4
Darko Brašanac,SRB,MF,Leganés,La Liga,32,1992,18,26,11,5,15,6,9,17,52.9,8,24,11,13,16,42,34,0
Lilian Brassier,FRA,DF,Marseille,Ligue 1,24,1999,8.7,8,6,8,0,0,5,6,83.3,1,8,3,5,9,17,28,2
Lilian Brassier,FRA,DF,Rennes,Ligue 1,24,1999,13.7,15,12,11,4,0,9,11,81.8,2,17,10,7,22,37,62,1
Matthias Braunöder,AUT,MF,Como,Serie A,22,2002,3,10,4,6,3,1,7,11,63.6,4,3,0,3,2,12,4,1
Iker Bravo,ESP,"FW,MF",Udinese,Serie A,19,2005,7.6,10,6,3,5,2,5,9,55.6,4,4,1,3,1,11,4,0
James Bree,ENG,DF,Southampton,Premier League,26,1997,11.9,19,14,8,10,1,10,25,40,15,10,3,7,9,28,29,0
Tim Breithaupt,GER,MF,Augsburg,Bundesliga,22,2002,1.3,1,1,0,1,0,0,4,0,4,1,0,1,2,3,0,0
Gleison Bremer,BRA,DF,Juventus,Serie A,27,1997,6,15,7,9,5,1,4,5,80,1,15,11,4,6,21,16,0
Brenner,BRA,"MF,FW",Udinese,Serie A,24,2000,4.3,6,4,2,3,1,3,8,37.5,5,4,0,4,1,7,6,0
Ben Brereton,CHI,FW,Southampton,Premier League,25,1999,5,3,2,0,2,1,1,9,11.1,8,2,1,1,0,3,4,0
Marco Brescianini,ITA,MF,Atalanta,Serie A,24,2000,11,18,11,5,9,4,8,10,80,2,15,2,13,2,20,6,0
Maximilian Breunig,GER,"FW,MF",Heidenheim,Bundesliga,23,2000,3.9,4,3,1,2,1,3,6,50,3,9,2,7,1,5,3,0
Anthony Briançon,FRA,DF,Saint-Étienne,Ligue 1,29,1994,0,0,0,0,0,0,0,0,,0,0,0,0,0,0,0,0
Nathan Broadhead,WAL,"MF,FW",Ipswich Town,Premier League,26,1998,7.8,9,4,3,6,0,3,12,25,9,8,1,7,4,13,5,0
Armando Broja,ALB,FW,Everton,Premier League,22,2001,3.7,3,1,1,1,1,0,0,,0,3,0,3,1,4,4,0
David Brooks,WAL,"FW,MF",Bournemouth,Premier League,27,1997,10.7,14,6,2,8,4,2,16,12.5,14,18,2,16,5,19,9,1
Arvid Brorsson,SWE,DF,Monza,Serie A,25,1999,4,4,3,2,2,0,2,5,40,3,9,8,1,2,6,35,1
Moritz Broschinski,GER,"FW,MF",Bochum,Bundesliga,23,2000,15.4,19,14,6,6,7,6,15,40,9,18,0,18,1,20,18,0
Nathaniel Brown,GER,"DF,MF",Eint Frankfurt,Bundesliga,21,2003,21.6,71,42,39,18,14,44,55,80,11,30,0,30,15,86,55,1
Jacob Bruun Larsen,DEN,"FW,MF",Hoffenheim,Bundesliga,25,1998,4.4,4,3,1,2,1,3,8,37.5,5,5,1,4,1,5,2,0
Jacob Bruun Larsen,DEN,"MF,FW",Stuttgart,Bundesliga,25,1998,4.6,1,1,1,0,0,0,2,0,2,7,0,7,1,2,4,1
Tajon Buchanan,CAN,"DF,FW",Inter,Serie A,25,1999,1.1,3,0,2,0,1,1,2,50,1,0,0,0,0,3,3,0
Tajon Buchanan,CAN,MF,Villarreal,La Liga,25,1999,4.6,10,5,6,4,0,6,9,66.7,3,6,0,6,1,11,1,0
Ante Budimir,CRO,FW,Osasuna,La Liga,33,1991,32.8,20,9,3,11,6,3,13,23.1,10,19,4,15,2,22,26,0
Emi Buendía,ARG,"MF,FW",Aston Villa,Premier League,27,1996,1.1,6,6,3,2,1,0,5,0,5,5,1,4,0,6,2,0
Emi Buendía,ARG,MF,Leverkusen,Bundesliga,27,1996,2.9,6,5,1,4,1,5,8,62.5,3,6,0,6,0,6,0,0
Manu Bueno,ESP,"MF,FW",Sevilla,La Liga,20,2004,1.6,4,3,0,1,3,1,2,50,1,0,0,0,0,4,2,0
Santiago Bueno,URU,DF,Wolves,Premier League,25,1998,18.7,41,21,22,18,1,17,22,77.3,5,36,21,15,15,56,70,0
Endika Buján,ESP,FW,Athletic Club,La Liga,21,2003,0.1,0,0,0,0,0,0,1,0,1,0,0,0,0,0,0,0
Marius Bülter,GER,"FW,DF",Hoffenheim,Bundesliga,31,1993,19.2,13,10,5,6,2,9,17,52.9,8,10,3,7,4,17,14,1
Facundo Buonanotte,ARG,"FW,MF",Leicester City,Premier League,19,2004,16.9,53,32,17,22,14,21,67,31.3,46,34,6,28,12,65,14,0
Alessandro Buongiorno,ITA,DF,Napoli,Serie A,25,1999,21.4,39,23,26,12,1,24,32,75,8,30,18,12,35,74,73,2
Cameron Burgess,AUS,DF,Ipswich Town,Premier League,28,1995,17.1,17,12,14,3,0,9,11,81.8,2,20,15,5,14,31,128,3
Jonathan Burkardt,GER,FW,Mainz 05,Bundesliga,24,2000,23.4,15,8,1,7,7,6,10,60,4,11,1,10,1,16,14,0
Oliver Burke,SCO,FW,Werder Bremen,Bundesliga,27,1997,10.1,11,4,5,1,5,4,6,66.7,2,20,0,20,2,13,6,0
Dan Burn,ENG,DF,Newcastle Utd,Premier League,32,1992,37,39,24,22,15,2,20,36,55.6,16,36,26,10,27,66,197,4
Rareș-Cătălin Burnete,ROU,FW,Lecce,Serie A,20,2004,0.3,0,0,0,0,0,0,1,0,1,0,0,0,0,0,0,0
Wes Burns,WAL,"FW,DF",Ipswich Town,Premier League,29,1994,10.3,13,11,1,9,3,4,10,40,6,7,2,5,10,23,13,2
Marnon Busch,GER,"DF,MF",Heidenheim,Bundesliga,29,1994,15.5,26,17,19,7,0,23,32,71.9,9,23,10,13,13,39,65,5
Gianluca Busio,USA,MF,Venezia,Serie A,22,2002,28,46,31,24,12,10,20,47,42.6,27,36,8,28,19,65,52,0
Aurélio Buta,POR,DF,Reims,Ligue 1,27,1997,21.9,37,24,22,11,4,21,42,50,21,19,5,14,22,59,59,0
Jean Butez,FRA,GK,Como,Serie A,29,1995,18.5,0,0,0,0,0,0,2,0,2,0,0,0,0,0,18,1
Nathan Butler-Oyedeji,ENG,FW,Arsenal,Premier League,21,2003,0.1,0,0,0,0,0,0,0,,0,0,0,0,0,0,0,0
Marcin Bułka,POL,GK,Nice,Ligue 1,24,1999,34,0,0,0,0,0,0,1,0,1,0,0,0,0,0,16,6
Pau Cabanes,ESP,"MF,FW",Villarreal,La Liga,19,2005,1.8,4,4,0,3,1,3,4,75,1,5,0,5,3,7,2,1
Pau Cabanes,ESP,"MF,FW",Alavés,La Liga,19,2005,2.1,8,2,4,3,1,6,13,46.2,7,2,0,2,0,8,1,0
Rémy Cabella,FRA,"FW,MF",Lille,Ligue 1,34,1990,11.2,39,19,16,13,10,19,33,57.6,14,10,1,9,8,47,5,0
Leandro Cabrera,URU,DF,Espanyol,La Liga,33,1991,31.9,40,23,29,8,3,19,33,57.6,14,35,25,10,30,70,199,2
Liberato Cacace,NZL,"MF,DF",Empoli,Serie A,23,2000,24.8,37,25,20,13,4,22,31,71,9,26,9,17,22,59,59,0
Alessio Cacciamani,ITA,"MF,DF",Torino,Serie A,17,2007,0.3,0,0,0,0,0,0,0,,0,0,0,0,1,1,0,0
Anthony Caci,FRA,DF,Mainz 05,Bundesliga,27,1997,29.8,60,40,23,25,12,28,44,63.6,16,33,8,25,27,87,47,2
Mathieu Cafaro,FRA,"MF,FW",Saint-Étienne,Ligue 1,27,1997,8.1,10,7,4,4,2,4,15,26.7,11,7,1,6,7,17,3,0
Moisés Caicedo,ECU,"MF,DF",Chelsea,Premier League,22,2001,37.2,114,73,44,54,16,54,86,62.8,32,49,10,39,49,163,60,1
Tom Cairney,SCO,MF,Fulham,Premier League,33,1991,7,13,5,5,2,6,4,7,57.1,3,7,1,6,4,17,3,1
Jens Cajuste,SWE,MF,Ipswich Town,Premier League,24,1999,21.8,44,22,19,23,2,21,49,42.9,28,25,10,15,28,72,33,2
Davide Calabria,ITA,DF,Bologna,Serie A,27,1996,7,12,8,5,5,2,5,12,41.7,7,4,0,4,3,15,22,1
Davide Calabria,ITA,DF,Milan,Serie A,27,1996,3.5,10,7,10,0,0,4,7,57.1,3,1,0,1,8,18,8,0
Riccardo Calafiori,ITA,DF,Arsenal,Premier League,22,2002,10.9,27,19,15,10,2,18,29,62.1,11,12,6,6,9,36,25,0
Luca Caldirola,ITA,DF,Monza,Serie A,33,1991,9.7,11,7,8,3,0,4,7,57.1,3,9,6,3,11,22,43,1
Fernando Calero,ESP,"DF,MF",Espanyol,La Liga,28,1995,7.9,18,10,13,4,1,8,12,66.7,4,16,9,7,16,34,50,1
Duje Ćaleta-Car,CRO,DF,Lyon,Ligue 1,27,1996,17.6,20,12,11,9,0,10,19,52.6,9,33,25,8,17,37,97,2
Hakan Çalhanoğlu,TUR,MF,Inter,Serie A,30,1994,20.9,43,22,7,23,13,21,36,58.3,15,17,8,9,17,60,24,0
Dominic Calvert-Lewin,ENG,FW,Everton,Premier League,27,1997,17.9,9,7,1,4,4,2,6,33.3,4,7,2,5,7,16,23,0
Drissa Camara,CIV,"MF,FW",Parma,Serie A,22,2002,5,9,7,2,6,1,1,10,10,9,8,0,8,3,12,1,0
Issiaga Camara,GUI,MF,Nice,Ligue 1,19,2005,0.2,2,1,0,2,0,0,1,0,1,0,0,0,3,5,0,0
Lamine Camara,SEN,MF,Monaco,Ligue 1,20,2004,22.8,66,41,22,34,10,26,48,54.2,22,30,4,26,31,97,32,1
Mahdi Camara,FRA,"MF,FW",Brest,Ligue 1,26,1998,29.5,71,40,16,38,17,24,46,52.2,22,40,5,35,33,104,29,0
Ousmane Camara,FRA,DF,Angers,Ligue 1,21,2003,2.8,4,3,3,1,0,1,2,50,1,1,1,0,0,4,18,0
Francesco Camarda,ITA,"FW,MF",Milan,Serie A,16,2008,2.3,5,2,0,2,3,2,6,33.3,4,2,1,1,0,5,3,0
Eduardo Camavinga,FRA,"MF,DF",Real Madrid,La Liga,21,2002,12.2,42,26,23,16,3,19,33,57.6,14,24,8,16,18,60,23,0
Nicolò Cambiaghi,ITA,FW,Bologna,Serie A,23,2000,6.9,16,10,6,7,3,5,10,50,5,9,0,9,2,18,2,0
Andrea Cambiaso,ITA,"DF,FW",Juventus,Serie A,24,2000,24.7,46,30,27,13,6,27,44,61.4,17,24,4,20,16,62,34,5
Axel Camblan,FRA,"MF,FW",Brest,Ligue 1,20,2003,0.3,1,1,0,0,1,1,2,50,1,1,0,1,0,1,0,0
Sergio Camello,ESP,FW,Rayo Vallecano,La Liga,23,2001,12.6,9,3,2,5,2,4,6,66.7,2,8,1,7,4,13,16,0
José Campaña,ESP,MF,Las Palmas,La Liga,31,1993,13.2,21,16,8,11,2,11,20,55,9,9,1,8,19,40,19,2
Thomas Campaniello,ITA,FW,Empoli,Serie A,16,2008,0.3,0,0,0,0,0,0,2,0,2,0,0,0,0,0,0,0
Cole Campbell,USA,"MF,FW",Dortmund,Bundesliga,18,2006,0.2,0,0,0,0,0,0,0,,0,0,0,0,0,0,1,0
Emre Can,GER,"DF,MF",Dortmund,Bundesliga,30,1994,23.4,50,28,30,16,4,18,36,50,18,31,17,14,20,70,89,3
Peio Canales,ESP,"MF,FW",Athletic Club,La Liga,19,2005,2.9,3,2,0,1,2,1,1,100,0,3,0,3,2,5,2,0
Matteo Cancellieri,ITA,"FW,MF",Parma,Serie A,22,2002,15.8,26,16,15,9,2,11,32,34.4,21,15,1,14,13,39,30,0
Fali Candé,GNB,DF,Venezia,Serie A,26,1998,17,25,19,14,10,1,16,23,69.6,7,21,15,6,15,40,90,2
Antonio Candela,ITA,DF,Venezia,Serie A,24,2000,11.2,31,21,13,11,7,18,26,69.2,8,7,5,2,8,39,22,2
Antonio Candela,ITA,DF,Valladolid,La Liga,24,2000,10.1,9,6,6,2,1,4,11,36.4,7,11,6,5,6,15,33,0
Sergi Canós,ESP,"MF,FW",Valencia,La Liga,27,1997,4.1,11,7,3,4,4,4,10,40,6,6,1,5,5,16,5,0
Jaydee Canvot,FRA,"DF,MF",Toulouse,Ligue 1,18,2006,12.3,23,11,16,5,2,12,18,66.7,6,10,2,8,11,34,54,1
Pierrick Capelle,FRA,MF,Angers,Ligue 1,37,1987,5.4,24,17,10,9,5,9,18,50,9,4,1,3,11,35,5,1
Gianluca Caprari,ITA,"MF,FW",Monza,Serie A,31,1993,18.3,19,11,8,8,3,7,14,50,7,14,0,14,8,27,2,1
Elia Caprile,ITA,GK,Cagliari,Serie A,22,2001,18,1,0,1,0,0,0,2,0,2,0,0,0,0,1,9,1
Elia Caprile,ITA,GK,Napoli,Serie A,22,2001,3.6,0,0,0,0,0,0,0,,0,0,0,0,0,0,2,0
Gabin Capuano,FRA,FW,Lens,Ligue 1,18,2006,0.1,0,0,0,0,0,0,0,,0,0,0,0,0,0,0,0
Francesco Caputo,ITA,FW,Empoli,Serie A,36,1987,0.1,0,0,0,0,0,0,0,,0,0,0,0,0,0,0,0
Maxence Caqueret,FRA,MF,Como,Serie A,24,2000,12.1,36,21,14,18,4,20,38,52.6,18,15,1,14,7,43,4,1
Maxence Caqueret,FRA,MF,Lyon,Ligue 1,24,2000,6.4,21,11,5,11,5,4,22,18.2,18,12,2,10,7,28,2,0
Simon Cara,FRA,"MF,FW",Montpellier,Ligue 1,19,2005,0.1,0,0,0,0,0,0,0,,0,0,0,0,0,0,0,0
Andrea Carboni,ITA,DF,Monza,Serie A,23,2001,24.3,60,35,39,17,4,35,53,66,18,31,16,15,27,87,106,4
Franco Carboni,ITA,DF,Venezia,Serie A,21,2003,2.5,5,3,5,0,0,5,8,62.5,3,1,1,0,0,5,11,0
Valentin Carboni,ARG,"MF,FW",Marseille,Ligue 1,19,2005,1.1,2,2,0,1,1,0,1,0,1,1,0,1,1,3,1,0
Dani Cárdenas,ESP,GK,Rayo Vallecano,La Liga,27,1997,6,0,0,0,0,0,0,0,,0,0,0,0,0,0,3,0
Irvin Cardona,FRA,"FW,MF",Espanyol,La Liga,26,1997,6.7,8,5,2,4,2,6,16,37.5,10,5,1,4,4,12,10,0
Irvin Cardona,FRA,FW,Saint-Étienne,Ligue 1,26,1997,11.8,6,5,3,3,0,2,14,14.3,12,16,3,13,4,10,6,2
Marc Cardona,ESP,"FW,DF",Las Palmas,La Liga,29,1995,1.5,4,2,1,3,0,0,1,0,1,0,0,0,0,4,0,0
Sergi Cardona,ESP,DF,Villarreal,La Liga,25,1999,32.7,71,48,44,20,7,49,79,62,30,52,7,45,40,111,122,1
Johnny Cardoso,USA,MF,Betis,La Liga,22,2001,23.8,55,31,12,35,8,20,52,38.5,32,27,12,15,48,103,64,1
Tiago Cardoso,LUX,GK,Gladbach,Bundesliga,18,2006,4.2,1,0,1,0,0,1,1,100,0,0,0,0,0,1,2,2
Patrik Carlgren,SWE,GK,Nantes,Ligue 1,32,1992,4.6,0,0,0,0,0,0,0,,0,0,0,0,0,0,0,0
Diego Carlos,BRA,DF,Aston Villa,Premier League,31,1993,9.2,8,3,6,1,1,4,6,66.7,2,13,7,6,5,13,36,2
José Carlos González,ESP,DF,Las Palmas,La Liga,18,2006,0.1,0,0,0,0,0,0,0,,0,0,0,0,0,0,0,0
Carmona,ESP,DF,Sevilla,La Liga,22,2002,32.7,83,59,53,21,9,41,77,53.2,36,37,11,26,68,151,92,3
Marco Carnesecchi,ITA,GK,Atalanta,Serie A,24,2000,34,0,0,0,0,0,0,0,,0,1,0,1,0,0,26,2
Sergio Carreira,ESP,"MF,DF",Celta Vigo,La Liga,23,2000,18.4,28,16,16,6,6,14,26,53.8,12,20,2,18,17,45,37,0
Dani Carvajal,ESP,DF,Real Madrid,La Liga,32,1992,6.8,12,8,7,3,2,9,12,75,3,8,3,5,10,22,19,1
Fabio Carvalho,POR,"FW,MF",Brentford,Premier League,21,2002,5.1,13,9,4,4,5,6,13,46.2,7,6,1,5,3,16,2,0
William Carvalho,POR,MF,Betis,La Liga,32,1992,5.4,9,6,3,6,0,4,6,66.7,2,6,2,4,3,12,6,0
Cesare Casadei,ITA,MF,Torino,Serie A,21,2003,11.3,12,5,4,8,0,5,10,50,5,4,2,2,5,17,26,0
Marc Casado,ESP,MF,Barcelona,La Liga,20,2003,17.9,44,25,7,30,7,20,41,48.8,21,20,5,15,22,66,22,1
Nicolò Casale,ITA,DF,Bologna,Serie A,26,1998,10,11,5,4,6,1,5,10,50,5,15,7,8,17,28,43,3
Nicolò Casale,ITA,DF,Lazio,Serie A,26,1998,1.5,5,3,4,1,0,0,0,,0,4,3,1,1,6,2,0
Casemiro,BRA,MF,Manchester Utd,Premier League,32,1992,16.6,83,50,50,23,10,45,74,60.8,29,39,10,29,14,97,51,3
Kaelan Casey,ENG,DF,West Ham,Premier League,19,2004,0,0,0,0,0,0,0,0,,0,0,0,0,0,0,1,0
Matty Cash,POL,DF,Aston Villa,Premier League,26,1997,23,56,32,29,21,6,31,43,72.1,12,22,8,14,23,79,70,2
Eiran Cashin,IRL,DF,Brighton,Premier League,22,2001,0.2,0,0,0,0,0,0,1,0,1,0,0,0,0,0,2,0
Josué Casimir,FRA,"FW,MF",Le Havre,Ligue 1,22,2001,22.2,37,26,15,15,7,9,18,50,9,19,0,19,7,44,35,1
Federico Cassa,ITA,"MF,FW",Atalanta,Serie A,18,2006,0.2,0,0,0,0,0,0,0,,0,1,0,1,0,0,0,0
Cristian Cásseres Jr.,VEN,MF,Toulouse,Ligue 1,24,2000,30,96,61,41,43,12,46,88,52.3,42,35,9,26,42,138,36,1
Timothy Castagne,BEL,DF,Fulham,Premier League,28,1995,18.3,46,29,28,15,3,26,45,57.8,19,15,6,9,22,68,83,0
Valentín Castellanos,ARG,FW,Lazio,Serie A,25,1998,26.5,13,6,2,4,7,1,10,10,9,18,2,16,6,19,25,0
Jean-Charles Castelletto,CMR,"DF,MF",Nantes,Ligue 1,29,1995,29.1,34,17,17,15,2,17,27,63,10,27,18,9,25,59,151,0
Santiago Castro,ARG,FW,Bologna,Serie A,19,2004,25.5,18,10,4,9,5,6,17,35.3,11,13,2,11,3,21,20,0
Gaetano Castrovilli,ITA,MF,Monza,Serie A,27,1997,6.6,12,7,10,2,0,4,11,36.4,7,8,2,6,2,14,9,0
Gaetano Castrovilli,ITA,"MF,FW",Lazio,Serie A,27,1997,1.6,5,2,3,1,1,2,4,50,2,3,0,3,3,8,1,0
Danilo Cataldi,ITA,MF,Fiorentina,Serie A,29,1994,19,25,16,13,10,2,14,27,51.9,13,17,8,9,22,47,35,0
Catena,ESP,DF,Osasuna,La Liga,29,1994,34.2,46,28,34,10,2,27,44,61.4,17,40,25,15,35,81,221,2
Maximiliano Caufriez,BEL,DF,Valencia,La Liga,27,1997,1,1,1,1,0,0,1,1,100,0,2,1,1,1,2,4,0
Enzo Caumont,FRA,MF,Angers,Ligue 1,20,2004,0.4,1,1,0,1,0,1,2,50,1,1,1,0,1,2,1,0
Dani Ceballos,ESP,MF,Real Madrid,La Liga,27,1996,13.5,41,21,17,18,6,20,40,50,20,16,4,12,14,55,10,2
Abdoulie Ceesay,GAM,FW,St. Pauli,Bundesliga,20,2004,0.7,3,3,1,1,1,2,3,66.7,1,2,0,2,0,3,1,0
Zeki Çelik,TUR,DF,Roma,Serie A,27,1997,25.1,62,37,21,31,10,23,43,53.5,20,28,9,19,15,77,84,3
Fabien Centonze,FRA,DF,Nantes,Ligue 1,28,1996,2.9,8,4,5,2,1,4,6,66.7,2,4,1,3,2,10,17,0
Alberto Cerri,ITA,FW,Como,Serie A,28,1996,1,0,0,0,0,0,0,0,,0,2,0,2,0,0,1,0
Franco Cervi,ARG,"FW,MF",Celta Vigo,La Liga,30,1994,3,8,3,2,6,0,3,8,37.5,5,4,0,4,8,16,7,0
Julian Chabot,GER,DF,Stuttgart,Bundesliga,26,1998,25.2,37,24,19,15,3,15,32,46.9,17,29,19,10,38,75,135,0
El Chadaille Bitshiabu,FRA,DF,RB Leipzig,Bundesliga,19,2005,12.6,27,18,17,9,1,10,19,52.6,9,25,14,11,13,40,97,2
Fares Chaïbi,ALG,"MF,FW",Eint Frankfurt,Bundesliga,21,2002,11.3,13,9,4,5,4,7,20,35,13,10,0,10,10,23,32,1
Trevoh Chalobah,ENG,DF,Crystal Palace,Premier League,25,1999,11.8,20,16,7,12,1,12,23,52.2,11,19,9,10,19,39,57,3
Trevoh Chalobah,ENG,DF,Chelsea,Premier League,25,1999,10.1,11,7,5,6,0,7,8,87.5,1,6,3,3,10,21,48,1
Timothy Chandler,USA,DF,Eint Frankfurt,Bundesliga,34,1990,0.3,0,0,0,0,0,0,0,,0,0,0,0,3,3,2,0
Conor Chaplin,ENG,"MF,FW",Ipswich Town,Premier League,27,1997,9.5,15,5,6,6,3,6,14,42.9,8,8,1,7,4,19,3,0
Brendan Chardonnet,FRA,DF,Brest,Ligue 1,29,1994,26.8,45,33,28,14,3,25,40,62.5,15,45,28,17,29,74,169,2
Gabriel Charpentier,CGO,FW,Parma,Serie A,25,1999,3,4,3,2,1,1,3,4,75,1,3,0,3,0,4,9,0
Raúl Chasco,ESP,DF,Valladolid,La Liga,20,2003,1.4,4,1,3,1,0,2,4,50,2,1,0,1,2,6,2,0
Anrie Chase,JPN,DF,Stuttgart,Bundesliga,20,2004,8.2,10,4,6,4,0,5,7,71.4,2,10,6,4,9,19,35,0
Pep Chavarría,ESP,"DF,FW",Rayo Vallecano,La Liga,26,1998,28.7,46,36,30,14,2,28,45,62.2,17,35,9,26,30,76,108,1
Arthur Chaves,BRA,DF,Hoffenheim,Bundesliga,23,2001,24.3,51,36,28,19,4,25,50,50,25,47,20,27,37,88,136,3
Jhoanner Chávez,ECU,"DF,MF",Lens,Ligue 1,22,2002,6.6,9,5,4,4,1,2,7,28.6,5,10,1,9,6,15,13,0
Walid Cheddira,MAR,FW,Napoli,Serie A,26,1998,0.1,0,0,0,0,0,0,0,,0,0,0,0,0,0,0,0
Walid Cheddira,MAR,FW,Espanyol,La Liga,26,1998,7.1,5,0,1,1,3,0,1,0,1,4,0,4,1,6,6,0
Chema,ESP,MF,Real Madrid,La Liga,19,2005,0.1,0,0,0,0,0,0,0,,0,0,0,0,0,0,1,0
Théo Chennahi,FRA,DF,Montpellier,Ligue 1,19,2005,2,6,3,3,3,0,4,7,57.1,3,3,0,3,2,8,6,0
Sidiki Cherif,FRA,FW,Angers,Ligue 1,17,2006,3.6,5,5,1,3,1,3,4,75,1,4,1,3,0,5,0,1
Rayan Cherki,FRA,"FW,MF",Lyon,Ligue 1,20,2003,22.7,15,12,3,8,4,6,28,21.4,22,6,0,6,7,22,6,0
Youssef Chermiti,POR,"FW,MF",Everton,Premier League,20,2004,0.5,0,0,0,0,0,0,1,0,1,0,0,0,0,0,0,0
Lucas Chevalier,FRA,GK,Lille,Ligue 1,22,2001,34,3,2,3,0,0,3,4,75,1,0,0,0,0,3,13,4
Fabio Chiarodia,ITA,DF,Gladbach,Bundesliga,19,2005,4.2,10,4,6,4,0,4,6,66.7,2,8,3,5,9,19,53,1
Julián Chicco,ARG,"MF,DF",Leganés,La Liga,26,1998,3.4,11,7,3,6,2,5,8,62.5,3,2,0,2,4,15,10,0
Leandro Chichizola,ARG,GK,Parma,Serie A,34,1990,1,0,0,0,0,0,0,0,,0,0,0,0,0,0,2,0
Federico Chiesa,ITA,FW,Liverpool,Premier League,26,1997,1.2,1,0,0,1,0,0,2,0,2,1,0,1,0,1,1,1
Ben Chilwell,ENG,DF,Crystal Palace,Premier League,27,1996,2.9,7,6,4,3,0,1,5,20,4,6,2,4,6,13,16,0
Chiquinho,POR,MF,Wolves,Premier League,24,2000,0.1,0,0,0,0,0,0,0,,0,0,0,0,0,0,0,0
Chiquinho,POR,"MF,FW",Mallorca,La Liga,24,2000,1.6,1,0,0,1,0,0,7,0,7,3,0,3,2,3,0,0
Pedro Chirivella,ESP,MF,Nantes,Ligue 1,27,1997,26.1,44,29,23,16,5,19,42,45.2,23,25,4,21,19,63,45,0
Joris Chotard,FRA,MF,Montpellier,Ligue 1,22,2001,21,39,27,17,20,2,20,46,43.5,26,28,10,18,19,58,52,1
Hamza Choudhury,BAN,"MF,DF",Leicester City,Premier League,26,1997,1.5,1,1,1,0,0,1,3,33.3,2,4,2,2,5,6,2,0
Andreas Christensen,DEN,DF,Barcelona,La Liga,28,1996,2.8,6,4,4,1,1,4,4,100,0,2,0,2,4,10,9,0
Ryan Christie,SCO,MF,Bournemouth,Premier League,29,1995,23.5,54,33,19,27,8,27,64,42.2,37,44,11,33,30,84,51,3
Carney Chukwuemeka,ENG,MF,Dortmund,Bundesliga,20,2003,2.8,7,5,3,2,2,1,1,100,0,5,0,5,1,8,1,0
Samuel Chukwueze,NGA,"FW,MF",Milan,Serie A,25,1999,10.3,17,11,7,6,4,5,19,26.3,14,3,0,3,2,19,9,0
Aaron Ciammaglichella,ITA,MF,Torino,Serie A,19,2005,0,0,0,0,0,0,0,0,,0,0,0,0,0,0,0,0
Jasper Cillessen,NED,GK,Las Palmas,La Liga,35,1989,25.9,1,0,1,0,0,1,4,25,3,0,0,0,0,1,11,2
Giuseppe Ciocci,ITA,GK,Cagliari,Serie A,22,2002,0.1,0,0,0,0,0,0,0,,0,0,0,0,0,0,0,0
Alessandro Circati,AUS,DF,Parma,Serie A,20,2003,6,7,5,6,1,0,1,2,50,1,5,4,1,3,10,42,1
Pathé Ciss,SEN,"MF,DF",Rayo Vallecano,La Liga,30,1994,23.8,49,24,26,22,1,20,41,48.8,21,31,10,21,40,89,61,3
Alphadjo Cissè,ITA,"FW,MF",Hellas Verona,Serie A,17,2006,0.1,0,0,0,0,0,0,0,,0,0,0,0,0,0,0,0
Djaoui Cissé,FRA,MF,Rennes,Ligue 1,20,2004,12.5,33,18,12,15,6,16,26,61.5,10,29,4,25,13,46,11,1
Seydouba Cissé,GUI,MF,Leganés,La Liga,23,2001,27.1,59,37,18,27,14,23,50,46,27,25,1,24,12,71,45,1
Yoann Cissé,FRA,MF,Auxerre,Ligue 1,19,2004,0.1,0,0,0,0,0,0,0,,0,0,0,0,1,1,0,0
Patrick Ciurria,ITA,"MF,DF",Monza,Serie A,29,1995,12.3,22,14,11,7,4,4,11,36.4,7,13,3,10,6,28,22,0
Harry Clarke,ENG,DF,Ipswich Town,Premier League,23,2001,4.2,5,3,3,2,0,3,6,50,3,5,4,1,4,9,14,3
Jack Clarke,ENG,"FW,MF",Ipswich Town,Premier League,23,2000,13.1,32,20,11,10,11,17,34,50,17,9,0,9,7,39,29,2
Alexis Claude-Maurice,FRA,"MF,FW",Augsburg,Bundesliga,26,1998,23.4,41,26,12,15,14,17,34,50,17,16,0,16,15,56,8,1
Jonathan Clauss,FRA,"DF,MF",Nice,Ligue 1,31,1992,25.6,52,35,27,19,6,28,56,50,28,25,2,23,48,100,68,3
Silvi Clúa,ESP,MF,Girona,La Liga,19,2005,1.8,8,7,4,3,1,4,6,66.7,2,1,0,1,2,10,6,0
Nathaniel Clyne,ENG,"DF,MF",Crystal Palace,Premier League,33,1991,5.4,12,8,8,3,1,6,11,54.5,5,4,2,2,3,15,14,1
Conor Coady,ENG,DF,Leicester City,Premier League,31,1993,19,13,9,6,6,1,3,6,50,3,32,24,8,13,26,71,2
Marcus Coco,FRA,DF,Nantes,Ligue 1,28,1996,10.6,27,21,15,9,3,16,31,51.6,15,16,5,11,11,38,46,0
Saúl Coco,EQG,DF,Torino,Serie A,25,1999,31.6,46,26,31,14,1,19,30,63.3,11,49,31,18,38,84,157,4
Séamus Coleman,IRL,DF,Everton,Premier League,35,1988,2.4,3,2,2,1,0,3,4,75,1,5,3,2,1,4,8,0
Nathan Collins,IRL,DF,Brentford,Premier League,23,2001,38,40,24,23,12,5,22,36,61.1,14,77,57,20,34,74,226,3
Nnamdi Collins,GER,DF,Eint Frankfurt,Bundesliga,20,2004,16.5,33,24,24,7,2,17,22,77.3,5,22,11,11,16,49,74,3
Toby Collyer,ENG,MF,Manchester Utd,Premier League,20,2004,2,12,9,6,6,0,5,6,83.3,1,2,1,1,2,14,3,0
Lorenzo Colombo,ITA,"FW,MF",Empoli,Serie A,22,2002,24.8,31,14,7,16,8,7,21,33.3,14,33,2,31,2,33,16,1
Andrea Colpani,ITA,"FW,MF",Fiorentina,Serie A,25,1999,15.9,15,9,5,7,3,4,12,33.3,8,7,0,7,8,23,10,0
Levi Colwill,ENG,DF,Chelsea,Premier League,21,2003,35,47,34,25,19,3,18,27,66.7,9,37,25,12,33,80,118,4
Florinel Coman,ROU,"FW,MF",Cagliari,Serie A,26,1998,2.9,5,3,3,1,1,2,2,100,0,2,0,2,1,6,3,0
Kingsley Coman,FRA,FW,Bayern Munich,Bundesliga,28,1996,14.2,17,12,6,6,5,8,12,66.7,4,12,0,12,8,25,15,0
Eray Cömert,SUI,"DF,MF",Valladolid,La Liga,26,1998,19.8,24,14,15,9,0,12,21,57.1,9,28,15,13,24,48,75,2
Santi Comesaña,ESP,MF,Villarreal,La Liga,27,1996,28.4,85,49,44,32,9,42,76,55.3,34,56,22,34,19,104,56,1
Pietro Comuzzo,ITA,DF,Fiorentina,Serie A,19,2005,23.4,43,21,29,11,3,23,29,79.3,6,35,22,13,29,72,113,4
Francisco Conceição,POR,"FW,MF",Juventus,Serie A,21,2002,14.9,23,14,6,9,8,13,30,43.3,17,7,0,7,6,29,6,0
Diego Conde,ESP,GK,Villarreal,La Liga,25,1998,21.8,2,2,2,0,0,2,4,50,2,0,0,0,1,3,9,2
Tomás Conechny,ARG,"FW,MF",Alavés,La Liga,26,1998,9.4,15,12,6,7,2,9,27,33.3,18,14,2,12,6,21,10,0
Alois Confais,FRA,MF,Le Havre,Ligue 1,27,1996,0,0,0,0,0,0,0,0,,0,0,0,0,0,0,0,0
Sirlord Conteh,GER,"FW,MF",Heidenheim,Bundesliga,28,1996,9.9,9,5,3,6,0,2,7,28.6,5,1,1,0,1,10,8,0
Lewis Cook,ENG,"MF,DF",Bournemouth,Premier League,27,1997,33.1,81,42,41,36,4,37,67,55.2,30,30,11,19,41,122,70,0
Copete,ESP,DF,Mallorca,La Liga,24,1999,17,29,17,18,10,1,11,12,91.7,1,24,16,8,17,46,123,2
Diego Coppola,ITA,DF,Hellas Verona,Serie A,20,2003,32.5,66,36,48,14,4,28,40,70,12,44,24,20,72,138,194,2
Francis Coquelin,FRA,MF,Nantes,Ligue 1,33,1991,2.5,9,5,5,3,1,3,4,75,1,3,1,2,6,15,3,0
Iker Córdoba,ESP,DF,Valencia,La Liga,18,2005,0.2,0,0,0,0,0,0,0,,0,0,0,0,0,0,1,0
Derek Cornelius,CAN,DF,Marseille,Ligue 1,26,1997,15.8,24,17,15,8,1,17,22,77.3,5,16,10,6,14,38,51,0
Maxwel Cornet,CIV,FW,Southampton,Premier League,27,1996,0.8,5,5,1,4,0,0,4,0,4,0,0,0,0,5,2,0
Maxwel Cornet,CIV,"FW,MF",Genoa,Serie A,27,1996,2.7,2,1,1,0,1,0,1,0,1,1,1,0,2,4,2,0
Pierre Cornud,FRA,DF,Saint-Étienne,Ligue 1,27,1996,6.4,12,10,6,4,2,8,17,47.1,9,9,4,5,9,21,28,1
Ángel Correa,ARG,"FW,MF",Atlético Madrid,La Liga,29,1995,8.9,9,3,4,1,4,5,15,33.3,10,10,0,10,4,13,8,0
Joaquín Correa,ARG,"FW,MF",Inter,Serie A,29,1994,8.1,11,5,4,7,0,4,13,30.8,9,3,0,3,0,11,6,0
Thierry Correia,POR,DF,Valencia,La Liga,25,1999,8.5,27,18,19,5,3,13,23,56.5,10,10,1,9,4,31,18,0
Alberto costa,POR,DF,Juventus,Serie A,20,2003,4,14,10,7,5,2,7,9,77.8,2,5,1,4,4,18,14,0
Coba da Costa,ESP,"MF,FW",Getafe,La Liga,22,2002,11.2,29,13,9,16,4,13,26,50,13,24,0,24,8,37,10,0
Danny da Costa,GER,DF,Mainz 05,Bundesliga,31,1993,22.3,42,23,23,15,4,17,27,63,10,19,10,9,27,69,95,3
David Costa,POR,"MF,FW",Lens,Ligue 1,23,2001,3.9,2,0,1,1,0,1,4,25,3,5,1,4,1,3,0,0
Logan Costa,CPV,DF,Villarreal,La Liga,23,2001,28.7,38,21,25,12,1,24,29,82.8,5,25,14,11,21,59,115,2
Logan Costa,CPV,DF,Toulouse,Ligue 1,23,2001,1,2,1,0,2,0,1,1,100,0,2,2,0,2,4,4,0
Samu Costa,POR,MF,Mallorca,La Liga,23,2000,29.4,90,44,45,42,3,35,79,44.3,44,48,15,33,32,122,85,1
Grégoire Coudert,FRA,GK,Brest,Ligue 1,25,1999,2,0,0,0,0,0,0,0,,0,0,0,0,0,0,1,0
Vladimír Coufal,CZE,DF,West Ham,Premier League,31,1992,11.9,22,15,13,7,2,10,22,45.5,12,13,11,2,8,30,39,1
Lassana Coulibaly,MLI,MF,Lecce,Serie A,28,1996,29.6,48,29,16,28,4,24,61,39.3,37,45,12,33,18,66,46,1
Lasso Coulibaly,CIV,"FW,MF",Auxerre,Ligue 1,21,2002,0.5,1,1,0,0,1,0,0,,0,0,0,0,0,1,0,0
Mamadou Coulibaly,FRA,MF,Monaco,Ligue 1,20,2004,0.1,1,0,0,1,0,0,0,,0,0,0,0,0,1,0,0
Soumaïla Coulibaly,FRA,DF,Brest,Ligue 1,20,2003,4.9,4,2,2,2,0,1,1,100,0,7,2,5,5,9,26,0
Tanguy Coulibaly,FRA,"FW,MF",Montpellier,Ligue 1,23,2001,16.5,32,24,13,15,4,14,33,42.4,19,18,2,16,11,43,3,1
Woyo Coulibaly,MLI,DF,Leicester City,Premier League,25,1999,1.2,6,4,4,2,0,2,2,100,0,3,1,2,5,11,1,0
Woyo Coulibaly,MLI,DF,Parma,Serie A,25,1999,12,13,10,9,2,2,5,11,45.5,6,19,2,17,8,21,25,0
Marius Courcoul,FRA,"MF,DF",Angers,Ligue 1,17,2007,3.4,5,2,3,2,0,2,5,40,3,4,0,4,5,10,9,0
Thibaut Courtois,BEL,GK,Real Madrid,La Liga,32,1992,30,0,0,0,0,0,0,0,,0,0,0,0,1,1,15,1
Yan Couto,BRA,"DF,FW",Dortmund,Bundesliga,22,2002,9.9,24,16,17,2,5,14,25,56,11,12,1,11,10,34,32,2
Nicolas Cozza,FRA,"DF,MF",Nantes,Ligue 1,25,1999,22.8,59,41,35,18,6,31,47,66,16,25,10,15,25,84,69,0
Aaron Cresswell,ENG,DF,West Ham,Premier League,34,1989,9.2,11,7,5,5,1,9,11,81.8,2,9,4,5,8,19,37,0
Charlie Cresswell,ENG,DF,Toulouse,Ligue 1,21,2002,28.8,35,23,19,15,1,28,46,60.9,18,44,28,16,28,63,191,3
Bryan Cristante,ITA,MF,Roma,Serie A,29,1995,22.7,48,29,18,24,6,15,26,57.7,11,20,10,10,19,67,36,1
Domen Črnigoj,SVN,MF,Venezia,Serie A,28,1995,1.5,4,2,0,1,3,1,2,50,1,5,2,3,4,8,4,0
Juan Cruz Armada,ESP,DF,Osasuna,La Liga,32,1992,16.6,26,14,11,13,2,15,24,62.5,9,15,4,11,9,35,68,0
Juan Cruz,ESP,"FW,MF",Leganés,La Liga,24,2000,25.1,32,19,14,16,2,17,35,48.6,18,18,2,16,13,45,31,0
Juan Cuadrado,COL,"DF,MF",Atalanta,Serie A,36,1988,9.2,19,9,9,6,4,11,23,47.8,12,14,2,12,7,26,9,0
Pau Cubarsí,ESP,DF,Barcelona,La Liga,17,2007,29.1,34,23,21,10,3,19,30,63.3,11,12,9,3,16,50,86,1
Cucho,COL,FW,Betis,La Liga,25,1999,12.7,15,10,2,5,8,6,11,54.5,5,13,1,12,7,22,4,0
Marc Cucurella,ESP,DF,Chelsea,Premier League,26,1998,33.2,67,45,31,31,5,32,61,52.5,29,49,16,33,28,95,95,3
Jorge Cuenca,ESP,DF,Fulham,Premier League,24,1999,3.9,6,2,5,1,0,3,8,37.5,5,4,4,0,2,8,26,0
Matheus Cunha,BRA,"MF,FW",Wolves,Premier League,25,1999,28.9,38,22,17,16,5,13,39,33.3,26,21,1,20,17,55,23,0
Patrick Cutrone,ITA,FW,Como,Serie A,26,1998,22.7,16,11,0,10,6,7,14,50,7,11,0,11,5,21,7,0
Tomáš Čvančara,CZE,FW,Gladbach,Bundesliga,23,2000,9.2,4,1,3,1,0,2,7,28.6,5,6,3,3,5,9,17,0
Wylan Cyprien,FRA,MF,Parma,Serie A,29,1995,0.3,0,0,0,0,0,0,1,0,1,1,0,1,1,1,0,0
Danilo D'Ambrosio,ITA,DF,Monza,Serie A,35,1988,12.2,28,15,17,10,1,14,23,60.9,9,12,8,4,15,43,36,2
Lucas Da Cunha,FRA,MF,Como,Serie A,23,2001,29,45,25,17,19,9,20,39,51.3,19,18,3,15,17,62,30,1
Samuel Dahl,SWE,"DF,MF",Roma,Serie A,24,2000,0.5,2,2,0,2,0,1,2,50,1,2,0,2,0,2,0,0
Finn Dahmen,GER,GK,Augsburg,Bundesliga,26,1998,19,1,0,1,0,0,1,2,50,1,0,0,0,0,1,9,0
Thomas Dähne,GER,GK,Holstein Kiel,Bundesliga,30,1994,9,0,0,0,0,0,0,0,,0,0,0,0,0,0,7,2
Mahmoud Dahoud,GER,MF,Eint Frankfurt,Bundesliga,28,1996,4,9,4,4,5,0,4,6,66.7,2,5,1,4,2,11,5,0
Patson Daka,ZAM,"FW,MF",Leicester City,Premier League,25,1998,8.2,19,10,6,9,4,7,18,38.9,11,7,1,6,1,20,12,0
Ameen Al-Dakhil,BEL,DF,Stuttgart,Bundesliga,22,2002,4.8,6,6,4,2,0,4,4,100,0,12,8,4,9,15,30,1
Thijs Dallinga,NED,FW,Bologna,Serie A,23,2000,12.8,10,5,0,4,6,3,3,100,0,10,1,9,1,11,13,1
Diogo Dalot,POR,DF,Manchester Utd,Premier League,25,1999,31.3,68,40,40,22,6,34,52,65.4,18,22,9,13,37,105,72,0
Mikkel Damsgaard,DEN,"MF,FW",Brentford,Premier League,24,2000,32.3,83,44,27,29,27,31,81,38.3,50,40,3,37,27,110,31,2
Maat Daniel Caprini,ITA,FW,Fiorentina,Serie A,18,2006,0.1,0,0,0,0,0,0,0,,0,0,0,0,0,0,0,0
Flavius Daniliuc,AUT,DF,Hellas Verona,Serie A,23,2001,11.2,26,21,14,9,3,15,24,62.5,9,10,3,7,7,33,27,0
Danilo,BRA,"MF,FW",Nott'ham Forest,Premier League,23,2001,3.1,8,4,7,1,0,3,6,50,3,2,1,1,4,12,3,0
Danilo,BRA,DF,Juventus,Serie A,33,1991,6.5,10,4,7,2,1,5,10,50,5,4,3,1,9,19,21,1
Arnaut Danjuma,NED,FW,Villarreal,La Liga,27,1997,2.2,2,1,0,1,1,0,1,0,1,1,0,1,0,2,0,0
Arnaut Danjuma,NED,"FW,MF",Girona,La Liga,27,1997,14.8,8,6,3,3,2,2,7,28.6,5,5,1,4,2,10,4,0
Jayden Danns,ENG,MF,Liverpool,Premier League,18,2006,0.1,0,0,0,0,0,0,1,0,1,0,0,0,0,0,0,0
Kévin Danois,FRA,MF,Auxerre,Ligue 1,20,2004,16.2,49,30,20,22,7,20,46,43.5,26,17,3,14,20,69,20,0
Kevin Danso,AUT,DF,Tottenham,Premier League,25,1998,9.4,7,5,4,3,0,6,11,54.5,5,15,14,1,6,13,71,1
Kevin Danso,AUT,DF,Lens,Ligue 1,25,1998,12,19,7,12,5,2,12,16,75,4,25,19,6,20,39,62,1
Dante,BRA,DF,Nice,Ligue 1,40,1983,21.8,32,15,17,13,2,15,29,51.7,14,29,14,15,34,66,74,1
Pape Daouda Diongue,SEN,"MF,FW",Strasbourg,Ligue 1,,,0.9,2,0,1,1,0,1,2,50,1,0,0,0,3,5,2,0
Mohamed Daramy,DEN,FW,Reims,Ligue 1,22,2002,0.2,0,0,0,0,0,0,0,,0,0,0,0,0,0,1,0
Bence Dárdai,HUN,MF,Wolfsburg,Bundesliga,18,2006,14.5,24,14,9,13,2,16,30,53.3,14,20,4,16,12,36,28,1
Sergi Darder,ESP,"MF,FW",Mallorca,La Liga,30,1993,30.5,40,26,15,16,9,17,46,37,29,19,1,18,16,56,23,1
Matteo Darmian,ITA,DF,Inter,Serie A,34,1989,19.8,28,17,12,12,4,14,25,56,11,14,6,8,10,38,39,0
Lukas Daschner,GER,"MF,FW",Bochum,Bundesliga,25,1998,4.6,4,2,1,2,1,2,9,22.2,7,5,0,5,0,4,5,0
Juan David Cabal,COL,DF,Juventus,Serie A,23,2001,5.1,10,4,7,3,0,8,12,66.7,4,2,0,2,2,12,14,1
Jonathan David,CAN,FW,Lille,Ligue 1,24,2000,28.4,24,8,3,12,9,9,21,42.9,12,13,2,11,7,31,10,1
Alphonso Davies,CAN,DF,Bayern Munich,Bundesliga,23,2000,17.3,30,17,7,17,6,17,26,65.4,9,14,1,13,13,43,22,2
Ben Davies,WAL,DF,Tottenham,Premier League,31,1993,14.8,17,11,8,8,1,9,17,52.9,8,28,19,9,12,29,81,1
Keinan Davis,ENG,FW,Udinese,Serie A,26,1998,11.8,9,4,1,4,4,3,6,50,3,2,1,1,1,10,5,0
Leif Davis,ENG,DF,Ipswich Town,Premier League,24,2000,30.5,46,27,33,9,4,30,48,62.5,18,25,8,17,25,71,77,3
Zuriko Davitashvili,GEO,"FW,MF",Saint-Étienne,Ligue 1,23,2001,30.9,22,14,9,7,6,15,49,30.6,34,20,0,20,14,36,14,0
Paweł Dawidowicz,POL,"DF,MF",Hellas Verona,Serie A,29,1995,20.5,45,24,20,22,3,18,27,66.7,9,16,6,10,20,65,70,2
Craig Dawson,ENG,DF,Wolves,Premier League,34,1990,10.8,15,3,8,6,1,12,15,80,3,16,11,5,9,24,52,1
Kevin De Bruyne,BEL,"MF,FW",Manchester City,Premier League,33,1991,18.9,17,9,7,5,5,5,23,21.7,18,8,0,8,7,24,10,1
Bobby De Cordova-Reid,JAM,FW,Leicester City,Premier League,31,1993,8.3,9,4,3,6,0,4,14,28.6,10,6,1,5,0,9,10,0
Charles De Ketelaere,BEL,"MF,FW",Atalanta,Serie A,23,2001,23,13,9,2,9,2,4,15,26.7,11,14,3,11,3,16,9,1
Rodrigo De Paul,ARG,MF,Atlético Madrid,La Liga,30,1994,23.4,33,26,12,16,5,14,33,42.4,19,25,2,23,6,39,15,3
Théo De Percin,MTQ,GK,Auxerre,Ligue 1,23,2001,2,0,0,0,0,0,0,1,0,1,0,0,0,0,0,3,0
Mattia De Sciglio,ITA,DF,Empoli,Serie A,31,1992,8.5,18,13,10,8,0,14,17,82.4,3,10,3,7,8,26,35,1
Lorenzo De Silvestri,ITA,DF,Bologna,Serie A,36,1988,11.8,11,6,7,1,3,7,16,43.8,9,12,4,8,10,21,32,0
Thibault De Smet,BEL,DF,Reims,Ligue 1,26,1998,2.1,6,4,5,1,0,4,4,100,0,5,3,2,4,10,12,0
Koni De Winter,BEL,DF,Genoa,Serie A,22,2002,23.7,33,19,21,8,4,17,25,68,8,11,7,4,25,58,118,3
Amar Dedić,BIH,DF,Marseille,Ligue 1,21,2002,3.5,5,4,2,2,1,3,10,30,7,0,0,0,3,8,12,1
Alessandro Deiola,ITA,MF,Cagliari,Serie A,28,1995,15.9,31,20,11,17,3,10,32,31.3,22,26,12,14,13,44,38,0
Romain Del Castillo,FRA,FW,Brest,Ligue 1,28,1996,14,31,22,9,13,9,19,32,59.4,13,16,0,16,6,37,5,0
Enrico Del Prato,ITA,DF,Parma,Serie A,24,1999,32.7,33,17,24,8,1,19,26,73.1,7,69,35,34,19,52,132,2
Thomas Delaine,FRA,DF,Strasbourg,Ligue 1,32,1992,0.1,1,1,1,0,0,1,1,100,0,0,0,0,1,2,1,0
Liam Delap,ENG,FW,Ipswich Town,Premier League,21,2003,28.8,11,8,3,3,5,2,15,13.3,13,8,0,8,2,13,28,0
Fisayo Dele-Bashiru,NGA,"MF,FW",Lazio,Serie A,23,2001,10.5,10,6,3,3,4,2,6,33.3,4,10,2,8,4,14,5,0
Andy Delort,ALG,FW,Montpellier,Ligue 1,32,1991,6.7,4,3,1,2,1,1,2,50,1,3,1,2,0,4,3,0
Olivier Deman,BEL,DF,Werder Bremen,Bundesliga,24,2000,0.7,6,3,2,4,0,2,7,28.6,5,3,1,2,3,9,4,0
Ali Dembélé,FRA,DF,Torino,Serie A,20,2004,4.3,9,5,6,3,0,4,4,100,0,6,2,4,1,10,11,1
Ousmane Dembélé,FRA,FW,Paris S-G,Ligue 1,27,1997,19.2,11,5,0,7,4,4,12,33.3,8,3,0,3,9,20,2,1
Ermedin Demirović,BIH,FW,Stuttgart,Bundesliga,26,1998,20.6,12,7,3,4,5,3,12,25,9,14,3,11,3,15,12,0
Sepp van den Berg,NED,DF,Brentford,Premier League,22,2001,28.7,39,24,25,10,4,19,29,65.5,10,52,38,14,21,60,134,3
Rémy Descamps,FRA,GK,Lyon,Ligue 1,28,1996,1,0,0,0,0,0,0,0,,0,0,0,0,0,0,0,0
Arthur Desmas,FRA,GK,Le Havre,Ligue 1,30,1994,18,0,0,0,0,0,0,1,0,1,0,0,0,0,0,9,1
Justin Devenny,NIR,MF,Crystal Palace,Premier League,20,2003,5.6,17,12,7,9,1,8,19,42.1,11,6,1,5,0,17,11,0
Kiernan Dewsbury-Hall,ENG,"MF,FW",Chelsea,Premier League,25,1998,2.9,8,5,1,1,6,4,6,66.7,2,2,0,2,2,10,9,1
Michele Di Gregorio,ITA,GK,Juventus,Serie A,27,1997,33,0,0,0,0,0,0,0,,0,0,0,0,1,1,14,0
Giovanni Di Lorenzo,ITA,DF,Napoli,Serie A,30,1993,37,66,44,35,25,6,42,65,64.6,23,19,6,13,31,97,85,1
Boulaye Dia,SEN,"MF,FW",Lazio,Serie A,27,1996,24.2,22,10,5,12,5,7,16,43.8,9,12,1,11,6,28,16,1
Mouctar Diakhaby,GUI,DF,Valencia,La Liga,27,1996,7.3,8,3,8,0,0,4,6,66.7,2,8,6,2,11,19,56,0
Mamadou Diakhon,FRA,"FW,MF",Reims,Ligue 1,18,2005,9.5,12,8,4,3,5,9,18,50,9,5,1,4,4,16,5,0
Bafodé Diakité,FRA,DF,Lille,Ligue 1,23,2001,30.7,31,18,17,11,3,18,26,69.2,8,30,17,13,27,58,99,5
Oumar Diakité,CIV,FW,Reims,Ligue 1,20,2003,18.1,20,13,7,8,5,9,19,47.4,10,13,2,11,3,23,9,0
Amad Diallo,CIV,"MF,FW",Manchester Utd,Premier League,22,2002,21.1,38,31,9,20,9,19,32,59.4,13,15,2,13,11,49,19,1
Assane Diao,SEN,"FW,MF",Como,Serie A,18,2005,13.9,25,14,9,10,6,12,28,42.9,16,8,1,7,3,28,19,0
Assane Diao,SEN,FW,Betis,La Liga,18,2005,3.1,5,3,1,3,1,4,9,44.4,5,3,0,3,0,5,3,0
Habib Diarra,SEN,"MF,FW",Strasbourg,Ligue 1,20,2004,26.1,22,13,6,13,3,8,20,40,12,22,6,16,13,35,46,3
Moussa Diarra,MLI,DF,Alavés,La Liga,23,2000,20.7,40,24,19,18,3,17,29,58.6,12,15,5,10,21,61,46,1
Rúben Dias,POR,DF,Manchester City,Premier League,27,1997,25.2,17,11,7,9,1,7,13,53.8,6,23,20,3,20,37,71,4
Krépin Diatta,SEN,"DF,FW",Monaco,Ligue 1,25,1999,5.6,18,12,13,2,3,14,24,58.3,10,5,1,4,9,27,12,2
Kandet Diawara,GUI,FW,Le Havre,Ligue 1,24,2000,0,0,0,0,0,0,0,0,,0,1,0,1,0,0,1,0
Mahamadou Diawara,FRA,MF,Le Havre,Ligue 1,19,2005,6.5,20,12,10,8,2,8,13,61.5,5,13,6,7,13,33,11,1
Mahamadou Diawara,FRA,MF,Lyon,Ligue 1,19,2005,0.2,1,0,0,1,0,1,3,33.3,2,2,0,2,0,1,0,0
Brahim Díaz,MAR,"FW,MF",Real Madrid,La Liga,24,1999,15.4,25,19,9,13,3,7,19,36.8,12,16,1,15,4,29,2,1
Daniel Díaz,ESP,MF,Real Sociedad,La Liga,18,2006,0.1,1,1,1,0,0,0,0,,0,1,0,1,0,1,0,0
Luis Díaz,COL,FW,Liverpool,Premier League,27,1997,26.7,39,26,13,20,6,15,39,38.5,24,19,0,19,7,46,7,1
Pedro Díaz,ESP,MF,Rayo Vallecano,La Liga,26,1998,13.5,23,15,7,14,2,14,41,34.1,27,16,0,16,7,30,7,1
Tyler Dibling,ENG,"FW,MF",Southampton,Premier League,18,2006,20.8,34,20,13,18,3,16,26,61.5,10,19,5,14,8,42,16,1
Diego,ESP,FW,Leganés,La Liga,24,2000,13.3,1,1,0,0,1,1,7,14.3,6,4,1,3,2,3,11,0
Justin Diehl,GER,"FW,DF",Stuttgart,Bundesliga,19,2004,1.2,1,0,0,1,0,1,1,100,0,2,0,2,0,1,0,0
Bamba Dieng,SEN,FW,Angers,Ligue 1,24,2000,5.9,4,1,1,2,1,0,2,0,2,2,0,2,0,4,3,0
Eric Dier,ENG,DF,Bayern Munich,Bundesliga,30,1994,16.3,19,11,8,9,2,13,20,65,7,19,8,11,20,39,77,1
Lucas Digne,FRA,DF,Aston Villa,Premier League,31,1993,26.1,65,38,40,16,9,44,66,66.7,22,23,4,19,25,90,89,1
Kembo Diliwidi,FRA,DF,Lens,Ligue 1,18,2006,0,0,0,0,0,0,0,0,,0,0,0,0,0,0,0,0
Federico Dimarco,ITA,"DF,FW",Inter,Serie A,26,1997,23.8,25,14,10,12,3,10,19,52.6,9,24,4,20,14,39,33,2
Stole Dimitrievski,MKD,GK,Valencia,La Liga,30,1993,4,0,0,0,0,0,0,0,,0,0,0,0,0,0,3,1
Junior Dina Ebimbe,FRA,"MF,FW",Eint Frankfurt,Bundesliga,23,2000,3.3,3,2,1,2,0,1,3,33.3,2,4,0,4,7,10,6,0
Eren Dinkçi,GER,"MF,FW",Freiburg,Bundesliga,22,2001,13.3,21,13,8,8,5,7,23,30.4,16,22,2,20,7,28,7,0
Sinaly Diomande,CIV,DF,Auxerre,Ligue 1,23,2001,21.6,39,19,20,18,1,28,40,70,12,37,18,19,30,69,100,2
Yan Diomandé,CIV,"MF,FW",Leganés,La Liga,17,2006,6.1,14,9,1,8,5,5,15,33.3,10,8,0,8,8,22,6,0
Lois Diony,FRA,FW,Angers,Ligue 1,31,1992,0.2,0,0,0,0,0,0,0,,0,0,0,0,0,0,0,0
Issa Diop,FRA,DF,Fulham,Premier League,27,1997,14.9,26,12,18,8,0,13,18,72.2,5,10,7,3,9,35,72,2
Sérigné Diop,SEN,FW,Brest,Ligue 1,19,2005,0,1,0,0,1,0,0,0,,0,1,0,1,0,1,0,0
Sofiane Diop,FRA,"MF,FW",Nice,Ligue 1,24,2000,11.8,23,16,16,3,4,9,22,40.9,13,19,2,17,17,40,7,1
Andy Diouf,FRA,MF,Lens,Ligue 1,21,2003,24.7,37,26,10,22,5,16,40,40,24,24,1,23,15,52,18,2
Yehvann Diouf,SEN,GK,Reims,Ligue 1,24,1999,34,2,1,2,0,0,1,3,33.3,2,0,0,0,1,3,22,4
Assane Dioussé,SEN,MF,Auxerre,Ligue 1,26,1997,7.4,15,7,9,5,1,5,14,35.7,9,6,2,4,12,27,15,0
Axel Disasi,FRA,DF,Aston Villa,Premier League,26,1998,5.4,8,5,7,1,0,3,7,42.9,4,4,1,3,5,13,18,0
Axel Disasi,FRA,DF,Chelsea,Premier League,26,1998,4,7,4,5,1,1,6,11,54.5,5,4,1,3,2,9,11,1
Roman Dixon,ENG,DF,Everton,Premier League,19,2004,1,5,5,3,2,0,4,4,100,0,1,0,1,1,6,3,0
Álvaro djaló,ESP,FW,Athletic Club,La Liga,24,1999,7.3,8,5,3,2,3,1,3,33.3,2,4,0,4,1,9,4,0
Djené,TOG,"DF,MF",Getafe,La Liga,32,1991,28.3,25,13,12,11,2,12,32,37.5,20,18,8,10,21,46,107,3
Nasser Djiga,BFA,DF,Wolves,Premier League,21,2002,0.7,0,0,0,0,0,0,1,0,1,0,0,0,2,2,4,1
Berat Djimsiti,ALB,DF,Atalanta,Serie A,31,1993,29.3,53,33,29,23,1,29,40,72.5,11,34,21,13,40,93,141,2
Marko Dmitrović,SRB,GK,Leganés,La Liga,32,1992,32,1,1,1,0,0,1,2,50,1,0,0,0,0,1,27,3
Ritsu Doan,JPN,"FW,MF",Freiburg,Bundesliga,26,1998,31.8,66,42,33,26,7,25,46,54.3,21,57,2,55,14,80,47,1
Dodô,BRA,DF,Fiorentina,Serie A,25,1998,33.6,44,29,25,11,8,25,49,51,24,22,5,17,34,78,58,2
Danilho Doekhi,NED,DF,Union Berlin,Bundesliga,26,1998,34,37,24,18,16,3,13,23,56.5,10,35,16,19,44,81,169,1
Matt Doherty,IRL,DF,Wolves,Premier League,32,1992,23.4,38,21,25,13,0,17,25,68,8,28,15,13,22,60,102,3
Jeremy Doku,BEL,"FW,MF",Manchester City,Premier League,22,2002,16.8,31,22,9,12,10,8,15,53.3,7,11,1,10,4,35,2,0
Marc Domenech,ESP,"FW,MF",Mallorca,La Liga,18,2006,3.4,4,4,2,1,1,2,5,40,3,2,0,2,0,4,2,0
Álex Domínguez,ESP,GK,Toulouse,Ligue 1,26,1998,0.2,0,0,0,0,0,0,0,,0,0,0,0,0,0,0,0
Benjamín Domínguez,ARG,FW,Bologna,Serie A,20,2003,14.2,18,7,2,11,5,6,20,30,14,15,1,14,4,22,7,0
Carlos Dominguez,ESP,DF,Celta Vigo,La Liga,23,2001,13.1,23,11,14,9,0,15,21,71.4,6,16,11,5,13,36,80,1
Israel Domínguez,ESP,FW,Sevilla,La Liga,21,2003,0.2,0,0,0,0,0,0,0,,0,0,0,0,0,0,0,0
Nicolás Domínguez,ARG,"MF,FW",Nott'ham Forest,Premier League,26,1998,21.8,86,45,40,35,11,36,76,47.4,40,38,12,26,29,115,54,1
Sergi Dominguez,ESP,DF,Barcelona,La Liga,19,2005,1.9,1,1,1,0,0,0,0,,0,0,0,0,3,4,7,0
Gianluigi Donnarumma,ITA,GK,Paris S-G,Ligue 1,25,1999,23.2,1,1,1,0,0,1,2,50,1,0,0,0,0,1,14,0
Patrick Dorgu,DEN,DF,Manchester Utd,Premier League,19,2004,9.4,31,24,15,14,2,16,23,69.6,7,11,0,11,4,35,23,2
Patrick Dorgu,DEN,"DF,FW",Lecce,Serie A,19,2004,20.4,45,27,21,19,5,23,45,51.1,22,24,6,18,18,63,42,2
Alfie Dorrington,ENG,DF,Tottenham,Premier League,19,2005,0.2,0,0,0,0,0,0,0,,0,0,0,0,0,0,0,0
Niklas Dorsch,GER,MF,Augsburg,Bundesliga,26,1998,0.4,0,0,0,0,0,0,0,,0,1,0,1,0,0,0,0
Niklas Dorsch,GER,MF,Heidenheim,Bundesliga,26,1998,14.8,27,16,12,15,0,13,22,59.1,9,14,1,13,17,44,17,2
Alberto Dossena,ITA,DF,Como,Serie A,25,1998,20.3,33,20,23,8,2,16,28,57.1,12,22,11,11,22,55,89,1
Abdoulaye Doucouré,MLI,MF,Everton,Premier League,31,1993,28.5,48,28,21,20,7,14,43,32.6,29,31,6,25,10,58,20,1
Cheick Doucouré,MLI,MF,Crystal Palace,Premier League,24,2000,5,16,8,6,8,2,5,11,45.5,6,4,0,4,11,27,10,1
Sékou Doucoure,FRA,DF,Nantes,Ligue 1,19,2005,0.1,0,0,0,0,0,0,0,,0,0,0,0,0,0,3,0
Désiré Doué,FRA,"FW,MF",Paris S-G,Ligue 1,19,2005,19.2,48,30,15,19,14,24,51,47.1,27,26,0,26,13,61,7,0
Guela Doué,CIV,DF,Strasbourg,Ligue 1,21,2002,30.2,65,45,40,15,10,37,54,68.5,17,38,6,32,34,99,154,1
Douglas,BRA,MF,Nantes,Ligue 1,27,1997,25.6,69,42,29,31,9,26,44,59.1,18,51,11,40,32,101,47,0
Ismaël Doukouré,FRA,"DF,MF",Strasbourg,Ligue 1,21,2003,29.3,40,22,19,18,3,17,25,68,8,31,14,17,25,65,102,3
Issa Doumbia,ITA,MF,Venezia,Serie A,20,2003,10.4,14,8,6,7,1,7,17,41.2,10,17,5,12,9,23,14,1
Kamory Doumbia,MLI,"MF,FW",Brest,Ligue 1,21,2003,14.7,41,29,17,17,7,14,31,45.2,17,17,1,16,28,69,13,1
Amidou Doumbouya,FRA,DF,Nice,Ligue 1,16,2007,0.5,1,1,0,0,1,1,1,100,0,3,1,2,1,2,1,0
Anastasios Douvikas,GRE,FW,Como,Serie A,24,1999,6.4,3,2,0,3,0,1,4,25,3,3,0,3,1,4,3,0
Anastasios Douvikas,GRE,FW,Celta Vigo,La Liga,24,1999,7.8,9,4,2,6,1,3,6,50,3,5,2,3,3,12,6,0
Artem Dovbyk,UKR,FW,Roma,Serie A,27,1997,26.9,4,2,0,1,3,0,4,0,4,10,3,7,2,6,12,0
Flynn Downes,ENG,MF,Southampton,Premier League,25,1999,23.9,49,25,23,21,5,15,36,41.7,21,28,9,19,32,81,51,4
Tommy Doyle,ENG,MF,Wolves,Premier League,22,2001,5.4,11,6,6,3,2,6,15,40,9,11,5,6,5,16,11,1
Radu Drăgușin,ROU,DF,Tottenham,Premier League,22,2002,13.9,10,6,8,2,0,6,12,50,6,22,16,6,15,25,49,4
Patrick Drewes,GER,GK,Bochum,Bundesliga,31,1993,21,0,0,0,0,0,0,1,0,1,1,0,1,0,0,11,1
Tim Drexler,GER,DF,Hoffenheim,Bundesliga,19,2005,4,17,7,11,6,0,9,12,75,3,6,4,2,1,18,9,1
Domingos Duarte,POR,DF,Getafe,La Liga,29,1995,20.7,28,15,22,4,2,17,21,81,4,28,16,12,18,46,152,1
Martin Dúbravka,SVK,GK,Newcastle Utd,Premier League,35,1989,10,0,0,0,0,0,0,0,,0,0,0,0,0,0,3,0
Marvin Ducksch,GER,FW,Werder Bremen,Bundesliga,30,1994,26.9,10,7,3,5,2,3,14,21.4,11,10,2,8,8,18,26,3
Ondrej Duda,SVK,MF,Hellas Verona,Serie A,29,1994,26.6,46,27,21,22,3,29,64,45.3,35,28,9,19,31,77,30,4
Duk,CPV,"MF,FW",Leganés,La Liga,24,2000,2,8,4,3,3,2,3,5,60,2,4,0,4,1,9,2,0
Denzel Dumfries,NED,"DF,FW",Inter,Serie A,28,1996,20.7,25,15,12,9,4,14,27,51.9,13,31,8,23,6,31,26,1
Alfred Duncan,GHA,MF,Venezia,Serie A,31,1993,10.6,17,8,4,11,2,5,14,35.7,9,7,2,5,8,25,8,0
Lewis Dunk,ENG,DF,Brighton,Premier League,32,1991,23.1,17,10,8,7,2,11,19,57.9,8,28,18,10,13,30,79,2
Jáder Durán,COL,FW,Aston Villa,Premier League,20,2003,7.1,8,7,1,2,5,1,4,25,3,5,0,5,0,8,13,0
Pablo Durán,ESP,"FW,MF",Celta Vigo,La Liga,23,2001,15.5,17,9,4,7,6,5,16,31.3,11,12,3,9,8,25,18,0
Julien Duranville,BEL,"FW,MF",Dortmund,Bundesliga,18,2006,3.1,3,0,0,3,0,1,2,50,1,1,0,1,0,3,3,0
Hugo Duro,ESP,FW,Valencia,La Liga,24,1999,24.1,13,8,4,7,2,5,13,38.5,8,11,2,9,10,23,11,0
Jean-Kevin Duverne,HAI,DF,Nantes,Ligue 1,27,1997,6,21,12,13,4,4,15,27,55.6,12,10,3,7,8,29,23,0
Paulo Dybala,ARG,"FW,MF",Roma,Serie A,30,1993,15.7,17,7,3,9,5,8,19,42.1,11,12,1,11,2,19,2,0
Stefan Džodić,SRB,"DF,MF",Montpellier,Ligue 1,19,2005,2.7,8,5,3,5,0,5,8,62.5,3,5,4,1,5,13,10,1
Adam Dźwigała,POL,"DF,MF",St. Pauli,Bundesliga,28,1995,4.1,20,10,13,6,1,11,16,68.8,5,6,1,5,4,24,28,0
Aron Dønnum,NOR,"DF,MF",Toulouse,Ligue 1,26,1998,29.9,56,35,25,24,7,31,55,56.4,24,29,4,25,28,84,37,1
Enzo Ebosse,CMR,DF,Udinese,Serie A,25,1999,1,0,0,0,0,0,0,2,0,2,3,3,0,1,1,1,0
Tyronne Ebuehi,NGA,"DF,MF",Empoli,Serie A,28,1995,0.8,3,2,1,2,0,1,1,100,0,1,0,1,2,5,0,0
Claudio Echeverri,ARG,FW,Manchester City,Premier League,18,2006,0.1,1,0,0,1,0,1,1,100,0,0,0,0,0,1,0,0
Ederson,BRA,GK,Manchester City,Premier League,30,1993,25.8,0,0,0,0,0,0,2,0,2,0,0,0,1,1,11,4
Éderson,BRA,MF,Atalanta,Serie A,25,1999,32,52,32,19,28,5,22,34,64.7,12,30,6,24,35,87,36,1
Noah Edjouma,FRA,"MF,FW",Toulouse,Ligue 1,18,2005,1.9,2,2,0,1,1,1,2,50,1,1,1,0,2,4,2,0
George Edmundson,ENG,DF,Ipswich Town,Premier League,26,1997,0,0,0,0,0,0,0,0,,0,0,0,0,0,0,0,0
Odsonne Édouard,FRA,"MF,FW",Crystal Palace,Premier League,26,1998,1.3,1,0,0,1,0,0,2,0,2,1,0,1,0,1,1,0
Odsonne Édouard,FRA,FW,Leicester City,Premier League,26,1998,0.3,1,1,1,0,0,0,0,,0,0,0,0,0,1,1,0
Samuel Edozie,ENG,"DF,FW",Southampton,Premier League,21,2003,0.7,3,1,0,1,2,2,2,100,0,0,0,0,0,3,0,0
Ronnie Edwards,ENG,DF,Southampton,Premier League,21,2003,0.1,0,0,0,0,0,0,0,,0,1,1,0,0,0,0,0
Johannes Eggestein,GER,FW,St. Pauli,Bundesliga,26,1998,20.6,5,3,0,2,3,1,5,20,4,5,0,5,0,5,8,0
Maximilian Eggestein,GER,MF,Freiburg,Bundesliga,27,1996,31.6,57,32,21,26,10,24,43,55.8,19,37,10,27,39,96,54,1
Kingsley Ehizibue,NED,DF,Udinese,Serie A,29,1995,27.8,55,35,31,18,6,25,41,61,16,41,14,27,23,78,70,5
Chidera Ejuke,NGA,FW,Sevilla,La Liga,26,1998,10.7,19,13,8,9,2,9,20,45,11,12,0,12,5,24,8,0
Jeff Ekhator,ITA,"FW,MF",Genoa,Serie A,17,2006,8.5,7,4,4,1,2,4,9,44.4,5,10,1,9,2,9,5,0
Hugo Ekitike,FRA,FW,Eint Frankfurt,Bundesliga,22,2002,28.5,16,12,3,8,5,4,12,33.3,8,13,1,12,7,23,24,0
Jurgen Ekkelenkamp,NED,MF,Udinese,Serie A,24,2000,21,36,25,10,22,4,18,35,51.4,17,26,4,22,12,48,26,0
Jacques Ekomie,GAB,"DF,FW",Angers,Ligue 1,20,2003,7.7,22,14,9,10,3,8,12,66.7,4,16,5,11,4,26,14,0
Emmanuel Ekong,SWE,"MF,FW",Empoli,Serie A,22,2002,2.1,4,3,0,2,2,3,3,100,0,2,1,1,1,5,1,0
Caleb Ekuban,GHA,FW,Genoa,Serie A,30,1994,6.2,3,3,1,1,1,1,1,100,0,4,1,3,1,4,6,0
Pierre Ekwah Elimby,FRA,MF,Saint-Étienne,Ligue 1,22,2002,28.6,54,33,18,30,6,34,56,60.7,22,26,12,14,47,101,72,1
Anthony Elanga,SWE,"FW,MF",Nott'ham Forest,Premier League,22,2002,27.8,19,14,8,8,3,5,17,29.4,12,11,1,10,6,25,25,0
Meschak Elia,COD,FW,Nantes,Ligue 1,26,1997,1.9,7,5,3,2,2,1,1,100,0,3,0,3,0,7,2,0
Mikael Ellertsson,ISL,"DF,MF",Venezia,Serie A,22,2002,27.4,58,26,37,14,7,33,61,54.1,28,42,5,37,17,75,79,0
Harvey Elliott,ENG,MF,Liverpool,Premier League,21,2003,4.1,5,3,3,1,1,2,8,25,6,7,2,5,1,6,3,1
Elif Elmas,MKD,"FW,MF",Torino,Serie A,24,1999,11.3,10,7,3,5,2,4,10,40,6,8,2,6,6,16,5,2
Elif Elmas,MKD,MF,RB Leipzig,Bundesliga,24,1999,0.5,3,1,3,0,0,1,3,33.3,2,2,0,2,0,3,2,0
Aritz Elustondo,ESP,DF,Real Sociedad,La Liga,30,1994,16.2,20,11,15,3,2,11,19,57.9,8,17,12,5,11,31,96,0
Nico Elvedi,SUI,DF,Gladbach,Bundesliga,27,1996,23.7,38,23,28,6,4,17,23,73.9,6,35,27,8,30,68,163,0
Adri Embarba,ESP,"FW,MF",Rayo Vallecano,La Liga,32,1992,17.9,41,20,17,17,7,18,47,38.3,29,18,1,17,13,54,14,2
Breel Embolo,SUI,"FW,MF",Monaco,Ligue 1,27,1997,20.5,22,17,7,7,8,5,16,31.3,11,11,0,11,3,25,10,1
Emanuel Emegha,NED,FW,Strasbourg,Ligue 1,21,2003,25.5,6,6,1,2,3,2,6,33.3,4,18,5,13,1,7,30,0
Emerson,BRA,DF,Milan,Serie A,25,1999,15.3,45,28,24,16,5,16,34,47.1,18,13,2,11,14,59,56,0
Yunus Emre Konak,TUR,"FW,MF",Brentford,Premier League,18,2006,0.5,4,4,0,4,0,1,2,50,1,2,0,2,0,4,0,0
Julio Enciso,PAR,"MF,FW",Ipswich Town,Premier League,20,2004,9.7,12,9,3,6,3,4,11,36.4,7,8,1,7,1,13,6,0
Julio Enciso,PAR,"MF,FW",Brighton,Premier League,20,2004,3.3,0,0,0,0,0,0,2,0,2,2,0,2,0,0,1,0
Wataru Endo,JPN,"MF,DF",Liverpool,Premier League,31,1993,3,12,8,7,5,0,6,10,60,4,8,1,7,6,18,9,0
Endrick,BRA,FW,Real Madrid,La Liga,18,2006,4,1,1,1,0,0,1,3,33.3,2,0,0,0,4,5,1,0
Yannik Engelhardt,GER,"MF,DF",Como,Serie A,23,2001,12.9,30,12,13,13,4,16,27,59.3,11,13,6,7,11,41,27,0
Arne Engels,BEL,"MF,FW",Augsburg,Bundesliga,20,2003,0.9,0,0,0,0,0,0,0,,0,1,1,0,0,0,0,0
Christian Eriksen,DEN,MF,Manchester Utd,Premier League,32,1992,11.8,19,9,4,12,3,11,27,40.7,16,15,5,10,7,26,8,0
Martin Erlic,CRO,DF,Bologna,Serie A,26,1998,3.7,2,0,0,2,0,1,2,50,1,5,4,1,2,4,9,0
Patrick Erras,GER,DF,Holstein Kiel,Bundesliga,29,1995,9.2,8,5,6,2,0,2,9,22.2,7,13,11,2,9,17,64,0
Alfonso Espino,URU,DF,Rayo Vallecano,La Liga,32,1992,9.3,41,24,31,8,2,26,47,55.3,21,19,6,13,12,53,32,1
Sebastiano Esposito,ITA,"FW,MF",Empoli,Serie A,22,2002,25.9,57,29,15,31,11,18,35,51.4,17,20,2,18,12,69,14,0
Romain Esse,ENG,MF,Crystal Palace,Premier League,19,2005,1.5,8,6,4,2,2,5,5,100,0,2,0,2,1,9,2,0
Samuel Essende,COD,FW,Augsburg,Bundesliga,26,1998,18.2,7,6,1,3,3,3,4,75,1,13,2,11,0,7,11,1
Dario Essugo,POR,MF,Las Palmas,La Liga,19,2005,21.5,59,45,28,26,5,28,46,60.9,18,28,11,17,42,101,47,7
Estanis,ESP,FW,Bologna,Serie A,20,2003,0.1,0,0,0,0,0,0,0,,0,0,0,0,0,0,0,0
Nahuel Estévez,ARG,MF,Parma,Serie A,28,1995,7.3,16,6,7,8,1,6,15,40,9,9,2,7,3,19,26,0
Pervis Estupiñán,ECU,DF,Brighton,Premier League,26,1998,26.7,65,43,33,25,7,34,51,66.7,17,20,5,15,37,102,65,2
Etienne Eto'o,CMR,FW,Rayo Vallecano,La Liga,21,2002,0.4,0,0,0,0,0,0,1,0,1,0,0,0,0,0,1,0
Karl Etta,CMR,"MF,FW",Villarreal,La Liga,20,2003,0.4,0,0,0,0,0,0,1,0,1,1,0,1,0,0,0,0
Evanilson,BRA,FW,Bournemouth,Premier League,24,1999,25.8,16,10,6,5,5,8,12,66.7,4,11,2,9,1,17,21,0
Jake Evans,,FW,Leicester City,Premier League,,,0.3,1,1,0,0,1,0,1,0,1,0,0,0,0,1,1,0
Jonny Evans,NIR,DF,Manchester Utd,Premier League,36,1988,3.5,8,6,4,4,0,3,6,50,3,3,2,1,5,13,15,0
Edu Expósito,ESP,MF,Espanyol,La Liga,27,1996,11.6,23,13,9,13,1,9,23,39.1,14,3,0,3,15,38,21,2
Eberechi Eze,ENG,"MF,FW",Crystal Palace,Premier League,26,1998,28.8,39,22,14,16,9,17,36,47.2,19,27,0,27,11,50,10,3
Abde Ezzalzouli,MAR,"FW,MF",Betis,La Liga,22,2001,22,37,25,17,16,4,15,27,55.6,12,22,3,19,7,44,19,0
Giovanni Fabbian,ITA,MF,Bologna,Serie A,21,2003,11.4,10,6,1,3,6,7,13,53.8,6,7,2,5,2,12,4,0
Łukasz Fabiański,POL,GK,West Ham,Premier League,39,1985,12.9,0,0,0,0,0,0,1,0,1,0,0,0,0,0,5,1
Alieu Fadera,GAM,"FW,DF",Como,Serie A,22,2001,18.3,64,47,25,27,12,20,45,44.4,25,18,1,17,12,76,10,0
Wout Faes,BEL,DF,Leicester City,Premier League,26,1998,31.3,42,26,26,14,2,25,48,52.1,23,48,35,13,26,68,185,4
Nicolò Fagioli,ITA,MF,Fiorentina,Serie A,23,2001,10.7,19,10,8,9,2,9,22,40.9,13,11,2,9,5,24,12,2
Nicolò Fagioli,ITA,MF,Juventus,Serie A,23,2001,6.3,14,10,7,6,1,6,9,66.7,3,4,0,4,2,16,5,0
Romain Faivre,FRA,"MF,FW",Brest,Ligue 1,26,1998,10,13,10,4,5,4,5,10,50,5,8,0,8,4,17,3,1
Wladimiro Falcone,ITA,GK,Lecce,Serie A,29,1995,38,0,0,0,0,0,0,0,,0,0,0,0,0,0,29,3
Davide Faraoni,ITA,DF,Hellas Verona,Serie A,32,1991,2.9,10,9,5,5,0,3,9,33.3,6,7,3,4,2,12,12,1
Abdul Fatawu Issahaku,GHA,FW,Leicester City,Premier League,20,2004,6.4,21,15,13,2,6,11,19,57.9,8,7,0,7,4,25,12,0
Ansu Fati,ESP,FW,Barcelona,La Liga,21,2002,2.6,4,1,0,2,2,1,2,50,1,1,0,1,1,5,0,1
Khalil Fayad,FRA,"MF,FW",Montpellier,Ligue 1,20,2004,11.4,31,16,12,17,2,15,28,53.6,13,18,1,17,10,41,15,1
Jacopo Fazzini,ITA,MF,Empoli,Serie A,21,2003,15.4,32,19,11,16,5,13,23,56.5,10,13,1,12,6,38,24,0
Nabil Fekir,FRA,MF,Betis,La Liga,31,1993,2,3,2,1,1,1,1,2,50,1,2,0,2,0,3,0,0
Mattia Felici,ITA,"MF,FW",Cagliari,Serie A,23,2001,10.3,17,12,8,7,2,4,11,36.4,7,10,0,10,7,24,7,1
Luiz Felipe,ITA,DF,Marseille,Ligue 1,27,1997,1.4,4,3,3,1,0,1,2,50,1,3,2,1,3,7,5,0
João Félix,POR,"FW,MF",Chelsea,Premier League,24,1999,4.1,8,3,2,5,1,5,9,55.6,4,2,0,2,3,11,2,0
João Félix,POR,MF,Milan,Serie A,24,1999,8.4,6,6,3,2,1,4,14,28.6,10,2,0,2,1,7,9,0
Frank Feller,GER,GK,Heidenheim,Bundesliga,20,2004,1.3,0,0,0,0,0,0,0,,0,0,0,0,0,0,1,0
Kiko Femenía,ESP,DF,Villarreal,La Liga,33,1991,24.7,50,34,34,14,2,33,57,57.9,24,21,10,11,40,90,62,3
Evan Ferguson,IRL,FW,West Ham,Premier League,19,2004,1.7,3,1,0,1,2,0,0,,0,2,1,1,1,4,1,0
Evan Ferguson,IRL,FW,Brighton,Premier League,19,2004,2.7,4,3,0,3,1,2,5,40,3,3,1,2,0,4,4,0
Lewis Ferguson,SCO,MF,Bologna,Serie A,24,1999,10.9,24,13,4,14,6,9,16,56.3,7,9,2,7,5,29,9,0
Zinedine Ferhat,ALG,"FW,MF",Angers,Ligue 1,31,1993,9.4,9,7,1,5,3,4,13,30.8,9,9,0,9,10,19,12,0
Bruno Fernandes,POR,MF,Manchester Utd,Premier League,29,1994,33.5,84,50,27,38,19,34,85,40,51,35,6,29,26,110,35,3
Edimilson Fernandes,SUI,"MF,DF",Brest,Ligue 1,28,1996,12.3,9,7,3,6,0,7,13,53.8,6,14,6,8,20,29,38,1
Mateus Fernandes,POR,MF,Southampton,Premier League,20,2004,32.3,89,48,45,28,16,33,72,45.8,39,43,8,35,28,117,35,7
Aitor Fernández,ESP,GK,Osasuna,La Liga,33,1991,1,0,0,0,0,0,0,0,,0,0,0,0,0,0,2,0
Álvaro Fernández,ESP,GK,Sevilla,La Liga,26,1998,8.3,0,0,0,0,0,0,1,0,1,0,0,0,0,0,7,0
Enzo Fernández,ARG,MF,Chelsea,Premier League,23,2001,32.7,65,33,17,30,18,31,84,36.9,53,43,7,36,13,78,23,4
Pelayo Fernandez,ESP,DF,Rayo Vallecano,La Liga,21,2003,1.1,0,0,0,0,0,0,0,,0,0,0,0,2,2,9,0
Roberto Férnandez,ESP,FW,Espanyol,La Liga,22,2002,16.6,4,4,2,1,1,0,5,0,5,9,1,8,3,7,26,0
Valery Fernández,ESP,"MF,FW",Mallorca,La Liga,24,1999,3.4,8,7,3,2,3,5,7,71.4,2,3,1,2,0,8,1,0
Matias Fernandez-Pardo,BEL,"FW,MF",Lille,Ligue 1,19,2005,11.8,12,9,3,6,3,6,12,50,6,9,0,9,3,15,6,0
André Ferreira,POR,GK,Valladolid,La Liga,28,1996,6,0,0,0,0,0,0,0,,0,0,0,0,0,0,4,2
Jordan Ferri,FRA,MF,Montpellier,Ligue 1,32,1992,19.7,42,23,18,22,2,18,44,40.9,26,20,3,17,9,51,20,0
Daniel Fila,CZE,FW,Venezia,Serie A,21,2002,5.5,2,0,0,1,1,0,2,0,2,6,0,6,0,2,5,0
Karol Fila,POL,MF,Strasbourg,Ligue 1,26,1998,0.1,0,0,0,0,0,0,0,,0,0,0,0,0,0,0,0
Kilian Fischer,GER,DF,Wolfsburg,Bundesliga,23,2000,25.5,64,44,48,12,4,47,89,52.8,42,41,8,33,19,83,98,2
Mark Flekken,NED,GK,Brentford,Premier League,31,1993,36.4,4,4,4,0,0,3,9,33.3,6,2,0,2,0,4,26,4
Alessandro Florenzi,ITA,FW,Milan,Serie A,33,1991,0.1,0,0,0,0,0,0,0,,0,0,0,0,0,0,0,0
Mateo Flores,ESP,MF,Betis,La Liga,20,2004,1.7,3,1,3,0,0,1,1,100,0,1,0,1,2,5,3,0
Phil Foden,ENG,"MF,FW",Manchester City,Premier League,24,2000,19.7,13,5,5,4,4,7,18,38.9,11,13,1,12,9,22,7,1
Malick Fofana,BEL,FW,Lyon,Ligue 1,19,2005,17.7,22,11,8,11,3,8,17,47.1,9,12,0,12,8,30,6,0
Rayan Fofana,FRA,"FW,MF",Lens,Ligue 1,18,2006,0.3,2,2,1,1,0,0,0,,0,0,0,0,0,2,0,0
Seko Fofana,CIV,MF,Rennes,Ligue 1,29,1995,9.4,11,7,4,6,1,2,7,28.6,5,7,1,6,7,18,7,0
Wesley Fofana,FRA,DF,Chelsea,Premier League,23,2000,13,13,12,6,7,0,6,14,42.9,8,14,9,5,14,27,55,2
Yahia Fofana,CIV,GK,Angers,Ligue 1,23,2000,33,0,0,0,0,0,0,2,0,2,0,0,0,1,1,25,2
Youssouf Fofana,FRA,MF,Milan,Serie A,25,1999,27.8,56,34,20,31,5,26,52,50,26,32,9,23,19,75,24,3
Jonas Föhrenbach,GER,DF,Heidenheim,Bundesliga,28,1996,20.4,45,24,25,15,5,22,35,62.9,13,29,3,26,16,61,57,0
Michael Folorunsho,ITA,"FW,MF",Fiorentina,Serie A,26,1998,7.2,19,12,9,6,4,8,20,40,12,9,1,8,4,23,10,0
Michael Folorunsho,ITA,"FW,MF",Napoli,Serie A,26,1998,0.4,3,2,0,3,0,2,4,50,2,0,0,0,1,4,1,1
Lamine Fomba,FRA,MF,Saint-Étienne,Ligue 1,26,1998,2.4,8,6,2,5,1,2,7,28.6,5,7,1,6,4,12,5,1
Carlos Forbs,POR,"MF,FW",Wolves,Premier League,20,2004,2.7,8,5,5,2,1,4,6,66.7,2,3,0,3,1,9,2,1
Pablo Fornals,ESP,"MF,FW",Betis,La Liga,28,1996,20.3,21,13,12,6,3,10,30,33.3,20,24,4,20,23,44,15,1
Omari Forson,ENG,"MF,FW",Monza,Serie A,20,2004,2.5,3,3,1,2,0,1,3,33.3,2,3,0,3,1,4,1,0
Fraser Forster,ENG,GK,Tottenham,Premier League,36,1988,7,0,0,0,0,0,0,1,0,1,0,0,0,0,0,7,3
Héctor Fort,ESP,DF,Barcelona,La Liga,17,2006,6.5,13,8,6,4,3,10,16,62.5,6,12,0,12,6,19,16,0
Dimitri Foulquier,FRA,DF,Valencia,La Liga,31,1993,25.5,48,31,29,13,6,24,36,66.7,12,21,5,16,16,64,86,1
Juan Foyth,ARG,DF,Villarreal,La Liga,26,1998,16.9,25,15,15,6,4,11,16,68.8,5,26,17,9,19,44,119,3
Fran,ESP,GK,Real Madrid,La Liga,19,2005,1,0,0,0,0,0,0,0,,0,0,0,0,0,0,2,0
Matheus França,BRA,"MF,FW",Crystal Palace,Premier League,20,2004,0.6,2,0,0,2,0,0,0,,0,1,1,0,1,3,1,0
Alejandro Francés,ESP,DF,Girona,La Liga,21,2002,13,36,24,22,13,1,28,40,70,12,17,8,9,17,53,52,0
Przemysław Frankowski,POL,DF,Lens,Ligue 1,29,1995,15.4,32,21,17,10,5,19,30,63.3,11,10,2,8,19,51,28,0
Enric Franquesa,ESP,"DF,FW",Leganés,La Liga,27,1997,6.8,17,9,9,6,2,9,13,69.2,4,7,1,6,5,22,12,0
Ryan Fraser,SCO,"FW,DF",Southampton,Premier League,30,1994,3.4,6,2,2,4,0,4,6,66.7,2,1,1,0,1,7,9,0
Davide Frattesi,ITA,MF,Inter,Serie A,24,1999,12.9,17,8,6,10,1,10,18,55.6,8,12,4,8,5,22,14,1
Tyler Fredricson,ENG,DF,Manchester Utd,Premier League,19,2005,1.8,5,3,3,2,0,1,2,50,1,2,0,2,1,6,11,0
Morten Frendrup,DEN,MF,Genoa,Serie A,23,2001,34.5,102,61,23,52,27,34,78,43.6,44,62,16,46,47,149,57,0
Martin Frese,DEN,DF,Hellas Verona,Serie A,26,1998,6.1,18,11,7,10,1,7,13,53.8,6,5,1,4,8,26,16,1
Remo Freuler,SUI,MF,Bologna,Serie A,32,1992,35.6,79,40,28,40,11,33,79,41.8,46,38,4,34,38,117,57,1
Marco Friedl,AUT,DF,Werder Bremen,Bundesliga,26,1998,24,62,42,35,26,1,38,66,57.6,28,41,24,17,34,96,130,1
Marvin Friedrich,GER,DF,Gladbach,Bundesliga,28,1995,11,15,9,12,3,0,9,16,56.3,7,16,12,4,5,20,57,0
Jeremie Frimpong,NED,"DF,MF",Leverkusen,Bundesliga,23,2000,25.7,33,25,14,12,7,16,29,55.2,13,25,0,25,8,41,22,1
Jorge de Frutos,ESP,"FW,MF",Rayo Vallecano,La Liga,27,1997,27.7,37,21,16,13,8,14,46,30.4,32,22,0,22,19,56,24,1
Darío Fuentes,ESP,DF,Sevilla,La Liga,21,2003,0.1,0,0,0,0,0,0,0,,0,0,0,0,0,0,0,0
Chris Führich,GER,"MF,FW",Stuttgart,Bundesliga,26,1998,22,15,10,5,5,5,13,27,48.1,14,23,2,21,6,21,19,0
Shiō Fukuda,JPN,FW,Gladbach,Bundesliga,20,2004,0.7,0,0,0,0,0,0,0,,0,1,0,1,0,0,0,0
Angelo Fulgini,FRA,"MF,FW",Lens,Ligue 1,27,1996,11.6,14,10,6,4,4,6,16,37.5,10,11,1,10,2,16,3,0
Niclas Füllkrug,GER,FW,West Ham,Premier League,31,1993,8.8,4,3,0,1,3,3,4,75,1,1,0,1,1,5,16,0
Kyogo Furuhashi,JPN,FW,Rennes,Ligue 1,29,1995,1.4,2,2,1,1,0,1,1,100,0,0,0,0,0,2,0,0
Manuel Fuster,ESP,"FW,MF",Las Palmas,La Liga,26,1997,11.1,19,11,5,8,6,15,28,53.6,13,13,3,10,4,23,17,0
Matteo Gabbia,ITA,DF,Milan,Serie A,24,1999,23.9,21,15,13,7,1,8,10,80,2,25,19,6,15,36,103,1
Tommaso Gabellini,ITA,FW,Torino,Serie A,17,2006,0.1,0,0,0,0,0,0,0,,0,0,0,0,0,0,0,0
Tiago Gabriel,POR,DF,Lecce,Serie A,19,2004,1.1,0,0,0,0,0,0,0,,0,4,2,2,0,0,11,0
Alessandro Gabrielloni,ITA,"FW,MF",Como,Serie A,30,1994,1.6,0,0,0,0,0,0,3,0,3,0,0,0,0,0,1,0
Gianluca Gaetano,ITA,"MF,FW",Cagliari,Serie A,24,2000,11.2,11,8,4,6,1,5,15,33.3,10,8,0,8,6,17,8,0
Roberto Gagliardini,ITA,"MF,DF",Monza,Serie A,30,1994,2,3,2,1,2,0,1,4,25,3,1,0,1,2,5,4,0
Cody Gakpo,NED,FW,Liverpool,Premier League,25,1999,21.5,28,16,6,13,9,13,25,52,12,23,3,20,12,40,19,1
Javi Galán,ESP,DF,Atlético Madrid,La Liga,29,1994,19.8,51,31,31,15,5,25,49,51,24,13,3,10,12,63,47,0
Iñigo Ruiz de Galarreta,ESP,MF,Athletic Club,La Liga,30,1993,16.4,36,22,11,17,8,20,31,64.5,11,11,4,7,16,52,14,2
Conor Gallagher,ENG,MF,Atlético Madrid,La Liga,24,2000,18.1,45,32,16,19,10,22,49,44.9,27,23,5,18,20,65,23,0
Antonino Gallo,ITA,DF,Lecce,Serie A,24,2000,29,65,42,46,15,4,34,62,54.8,28,33,6,27,20,85,133,0
Gauthier Gallon,FRA,GK,Rennes,Ligue 1,31,1993,0.5,0,0,0,0,0,0,0,,0,0,0,0,0,0,0,0
Cristian Gamboa,CRC,DF,Bochum,Bundesliga,34,1989,2.5,8,3,5,3,0,3,9,33.3,6,2,0,2,2,10,8,0
Idrissa Gana Gueye,SEN,MF,Everton,Premier League,34,1989,34,133,80,61,55,17,58,99,58.6,41,48,9,39,48,181,36,1
Ignatius Ganago,CMR,"FW,MF",Nantes,Ligue 1,25,1999,2.7,1,1,0,1,0,1,2,50,1,3,1,2,4,5,2,0
Silvère Ganvoula M'Boussy,CGO,FW,Monza,Serie A,28,1996,3.6,0,0,0,0,0,0,1,0,1,1,0,1,1,1,5,0
Facundo Garcés,MAS,DF,Alavés,La Liga,24,1999,7.5,6,2,4,2,0,3,5,60,2,8,6,2,5,11,51,0
Aleix García,ESP,MF,Leverkusen,Bundesliga,27,1997,16.2,13,7,4,6,3,7,15,46.7,8,12,2,10,11,24,24,1
Álvaro García,ESP,"FW,MF",Rayo Vallecano,La Liga,31,1992,28.4,33,24,19,8,6,12,31,38.7,19,31,0,31,32,65,42,1
Andrés García,ESP,"DF,MF",Aston Villa,Premier League,21,2003,3.5,9,5,5,3,1,4,8,50,4,2,0,2,2,11,10,2
Eric García,ESP,"DF,MF",Barcelona,La Liga,23,2001,17.4,38,21,11,24,3,20,29,69,9,24,8,16,14,52,41,0
Fran Garcia,ESP,DF,Real Madrid,La Liga,24,1999,24.1,51,36,29,16,6,28,51,54.9,23,27,5,22,28,79,67,1
Gonzalo García,ESP,"FW,DF",Real Madrid,La Liga,20,2004,0.6,0,0,0,0,0,0,0,,0,1,0,1,0,0,0,0
Joan García,ESP,GK,Espanyol,La Liga,23,2001,38,0,0,0,0,0,0,1,0,1,1,0,1,0,0,18,4
Pablo Garcia,ESP,FW,Betis,La Liga,17,2006,0.4,0,0,0,0,0,0,0,,0,1,0,1,0,0,0,0
Rubén García,ESP,"FW,MF",Osasuna,La Liga,31,1993,26.8,52,31,20,21,11,26,60,43.3,34,37,3,34,15,67,34,1
Ulisses Garcia,SUI,DF,Marseille,Ligue 1,28,1996,10.3,14,11,7,5,2,4,14,28.6,10,5,1,4,8,22,18,0
Unai García,ESP,DF,Osasuna,La Liga,32,1992,0.7,0,0,0,0,0,0,0,,0,1,0,1,0,0,1,0
Alejandro Garnacho,ARG,"MF,FW",Manchester Utd,Premier League,20,2004,24.4,30,18,11,6,13,12,37,32.4,25,19,0,19,13,43,11,2
James Garner,ENG,"MF,DF",Everton,Premier League,23,2001,17.7,47,31,25,20,2,24,41,58.5,17,20,4,16,23,70,37,0
Yarek Gasiorowski,ESP,DF,Valencia,La Liga,19,2005,10.5,19,16,16,3,0,9,13,69.2,4,17,6,11,26,45,60,0
Federico Gatti,ITA,DF,Juventus,Serie A,26,1998,24.4,28,23,18,8,2,14,24,58.3,10,27,18,9,18,46,76,2
Gavi,ESP,"MF,FW",Barcelona,La Liga,19,2004,12.1,30,21,10,15,5,15,26,57.7,11,14,1,13,10,40,7,0
Paulo Gazzaniga,ARG,GK,Girona,La Liga,32,1992,35.5,1,1,1,0,0,1,1,100,0,1,0,1,0,1,17,3
Jean-Philippe Gbamin,CIV,MF,Nantes,Ligue 1,28,1995,2.4,2,1,0,2,0,1,4,25,3,5,2,3,3,5,2,0
Mory Gbane,CIV,"DF,MF",Reims,Ligue 1,23,2000,12.5,20,11,16,4,0,13,24,54.2,11,12,10,2,18,38,90,1
Yann Gboho,FRA,"MF,FW",Toulouse,Ligue 1,23,2001,25.9,31,18,7,15,9,14,35,40,21,20,0,20,6,37,4,1
David de Gea,ESP,GK,Fiorentina,Serie A,33,1990,34,1,0,1,0,0,1,1,100,0,0,0,0,0,1,12,0
Viggo Gebel,GER,MF,RB Leipzig,Bundesliga,16,2007,0.2,0,0,0,0,0,0,0,,0,0,0,0,0,0,0,0
Lutsharel Geertruida,NED,DF,RB Leipzig,Bundesliga,24,2000,17.3,35,24,24,11,0,15,31,48.4,16,15,4,11,16,51,59,4
Dennis Geiger,GER,"MF,FW",Hoffenheim,Bundesliga,26,1998,8.2,24,11,9,13,2,12,19,63.2,7,15,2,13,7,31,6,1
Valentin Gendrey,FRA,DF,Lecce,Serie A,24,2000,2,2,2,1,0,1,1,1,100,0,3,1,2,2,4,1,0
Valentin Gendrey,FRA,DF,Hoffenheim,Bundesliga,24,2000,15.7,30,12,19,9,2,11,18,61.1,7,19,5,14,15,45,53,0
Denis Genreau,AUS,MF,Toulouse,Ligue 1,25,1999,2.5,7,5,4,1,2,4,8,50,4,3,0,3,3,10,4,0
Tyrique George,ENG,FW,Chelsea,Premier League,18,2006,2,2,0,2,0,0,2,3,66.7,1,1,0,1,2,4,1,0
Yannick Gerhardt,GER,"MF,DF",Wolfsburg,Bundesliga,30,1994,16.9,28,16,13,14,1,11,30,36.7,19,32,8,24,17,45,47,0
Max Geschwill,GER,DF,Holstein Kiel,Bundesliga,23,2001,14.2,26,21,13,12,1,14,19,73.7,5,14,9,5,30,56,53,1
Daniele Ghilardi,ITA,DF,Hellas Verona,Serie A,21,2003,22.5,44,29,27,17,0,25,41,61,16,29,15,14,30,74,106,0
Lautaro Gianetti,ARG,DF,Udinese,Serie A,30,1993,9.8,22,10,16,5,1,14,20,70,6,20,10,10,15,37,49,1
Dimitris Giannoulis,GRE,DF,Augsburg,Bundesliga,28,1995,29.4,47,32,27,16,4,26,44,59.1,18,49,11,38,47,94,75,0
Morgan Gibbs-White,ENG,MF,Nott'ham Forest,Premier League,24,2000,31.1,43,22,14,23,6,17,33,51.5,16,18,5,13,23,66,29,1
Samuel Gigot,FRA,DF,Lazio,Serie A,30,1993,7.6,4,3,1,3,0,0,1,0,1,8,6,2,13,17,36,0
Armin Gigovic,BIH,MF,Holstein Kiel,Bundesliga,22,2002,21.1,25,13,14,8,3,5,21,23.8,16,20,1,19,21,46,33,0
Bryan Gil,ESP,"FW,MF",Girona,La Liga,23,2001,19.1,34,20,10,15,9,14,30,46.7,16,24,0,24,10,44,9,4
Mario Gila,ESP,DF,Lazio,Serie A,23,2000,30.5,55,37,35,18,2,37,56,66.1,19,20,13,7,28,83,115,4
Billy Gilmour,SCO,MF,Brighton,Premier League,23,2001,1.1,3,3,2,1,0,3,4,75,1,1,0,1,0,3,1,0
Billy Gilmour,SCO,MF,Napoli,Serie A,23,2001,13.1,24,16,10,9,5,12,20,60,8,6,1,5,9,33,23,0
Benedikt Gimber,GER,DF,Heidenheim,Bundesliga,27,1997,29.7,72,46,48,23,1,38,63,60.3,25,53,19,34,31,103,131,1
Santiago Giménez,MEX,FW,Milan,Serie A,23,2001,7.4,5,3,0,4,1,3,4,75,1,3,1,2,1,6,13,0
Gvidas Gineitis,LTU,MF,Torino,Serie A,20,2004,15.9,25,15,8,10,7,13,25,52,12,16,6,10,18,43,32,0
Matthias Ginter,GER,DF,Freiburg,Bundesliga,30,1994,28.5,30,17,15,11,4,15,28,53.6,13,35,23,12,19,49,146,5
Jamie Gittens,ENG,"FW,MF",Dortmund,Bundesliga,19,2004,19.7,31,19,12,12,7,14,18,77.8,4,16,0,16,10,41,4,0
Serge Gnabry,GER,"FW,MF",Bayern Munich,Bundesliga,29,1995,13.8,20,11,6,7,7,8,12,66.7,4,11,0,11,6,26,9,0
Ben Godfrey,ENG,DF,Ipswich Town,Premier League,26,1998,1.8,1,0,1,0,0,1,1,100,0,1,1,0,2,3,3,0
Ben Godfrey,ENG,DF,Atalanta,Serie A,26,1998,0.3,0,0,0,0,0,0,1,0,1,1,1,0,0,0,0,0
Martial Godo,ENG,"FW,DF",Fulham,Premier League,21,2003,0.3,0,0,0,0,0,0,0,,0,1,0,1,1,1,0,0
Saba Goglichidze,GEO,DF,Empoli,Serie A,20,2004,28.2,64,37,36,25,3,25,51,49,26,36,17,19,33,97,97,3
Edoardo Goldaniga,ITA,DF,Como,Serie A,30,1993,28.1,34,21,21,8,5,13,18,72.2,5,21,10,11,33,67,102,3
Michael Golding,ENG,MF,Leicester City,Premier League,18,2006,0,0,0,0,0,0,0,0,,0,0,0,0,0,0,0,0
Pierluigi Gollini,ITA,GK,Genoa,Serie A,29,1995,7,0,0,0,0,0,0,0,,0,1,0,1,0,0,2,1
Aleksandr Golovin,RUS,"MF,FW",Monaco,Ligue 1,28,1996,12.8,38,24,9,20,9,17,39,43.6,22,16,4,12,12,50,7,0
André Gomes,POR,MF,Lille,Ligue 1,31,1993,14.2,27,13,9,11,7,11,31,35.5,20,7,1,6,6,33,11,2
Angel Gomes,ENG,MF,Lille,Ligue 1,23,2000,8.2,10,6,4,4,2,2,12,16.7,10,0,0,0,0,10,2,0
João Gomes,BRA,MF,Wolves,Premier League,23,2001,33,116,71,55,53,8,48,110,43.6,62,42,4,38,25,141,33,0
Rodrigo Gomes,POR,"DF,FW",Wolves,Premier League,21,2003,9,23,15,14,9,0,12,21,57.1,9,8,1,7,7,30,20,1
Toti Gomes,POR,DF,Wolves,Premier League,25,1999,29,61,43,42,15,4,37,46,80.4,9,29,17,12,25,86,152,5
Carlos Gómez,COL,"MF,DF",Rennes,Ligue 1,21,2002,4.2,8,6,3,4,1,3,9,33.3,6,6,0,6,2,10,2,0
Dani Gómez,ESP,FW,Valencia,La Liga,26,1998,5.9,3,2,0,0,3,0,0,,0,1,0,1,2,5,4,0
Diego Gómez,PAR,MF,Brighton,Premier League,21,2003,5.7,21,13,11,8,2,12,22,54.5,10,13,0,13,8,29,10,1
Joe Gomez,ENG,DF,Liverpool,Premier League,27,1997,5.8,13,10,5,7,1,11,16,68.8,5,9,6,3,7,20,20,2
Moi Gómez,ESP,"MF,FW",Osasuna,La Liga,30,1994,8.8,13,9,4,7,2,4,8,50,4,5,2,3,6,19,7,1
Sergi Gómez,ESP,DF,Espanyol,La Liga,32,1992,7.4,8,5,7,1,0,2,3,66.7,1,12,8,4,7,15,38,0
Sergio Gómez,ESP,"MF,DF",Real Sociedad,La Liga,23,2000,30.4,71,39,30,29,12,30,56,53.6,26,44,3,41,19,90,30,2
Unai Gómez,ESP,"MF,FW",Athletic Club,La Liga,21,2003,14.3,12,8,3,7,2,4,7,57.1,3,13,1,12,2,14,15,1
Tidiam Gomis,FRA,"MF,FW",RB Leipzig,Bundesliga,17,2006,1.7,0,0,0,0,0,0,0,,0,2,0,2,1,1,0,0
Fabio González,ESP,MF,Las Palmas,La Liga,27,1997,0.6,0,0,0,0,0,0,1,0,1,0,0,0,0,0,0,0
Nicolás González,ESP,MF,Manchester City,Premier League,22,2002,8.4,16,6,5,7,4,6,11,54.5,5,9,0,9,8,24,21,0
Nicolás González,ARG,"FW,MF",Juventus,Serie A,26,1998,19.4,24,13,10,9,5,9,25,36,16,16,4,12,9,33,37,2
Peter González,DOM,"MF,FW",Getafe,La Liga,22,2002,5.3,11,6,2,5,4,6,9,66.7,3,8,0,8,2,13,5,0
Urko González,ESP,MF,Espanyol,La Liga,23,2001,15.3,46,28,24,21,1,28,44,63.6,16,27,12,15,8,54,39,1
Urko González,ESP,MF,Real Sociedad,La Liga,23,2001,0.5,0,0,0,0,0,0,0,,0,1,1,0,0,0,0,0
Anthony Gordon,ENG,"FW,MF",Newcastle Utd,Premier League,23,2001,27,32,18,9,18,5,12,37,32.4,25,25,2,23,7,39,9,3
Leon Goretzka,GER,"MF,DF",Bayern Munich,Bundesliga,29,1995,14.7,21,11,5,12,4,10,20,50,10,27,7,20,20,41,25,1
Mathieu Gorgelin,FRA,GK,Le Havre,Ligue 1,33,1990,16,2,2,2,0,0,2,3,66.7,1,0,0,0,0,2,8,2
Andoni Gorosabel,ESP,DF,Athletic Club,La Liga,27,1996,16.5,47,28,31,9,7,30,45,66.7,15,18,2,16,18,65,62,0
Robin Gosens,GER,DF,Fiorentina,Serie A,30,1994,27,56,31,31,17,8,25,44,56.8,19,34,11,23,18,74,91,0
Robin Gosens,GER,DF,Union Berlin,Bundesliga,30,1994,1,0,0,0,0,0,0,3,0,3,1,0,1,1,1,2,0
Mario Götze,GER,"MF,FW",Eint Frankfurt,Bundesliga,32,1992,17.1,41,28,18,20,3,15,36,41.7,21,15,1,14,7,48,8,0
Amine Gouiri,ALG,"FW,MF",Marseille,Ligue 1,24,2000,11.6,5,5,0,1,4,2,3,66.7,1,9,0,9,1,6,1,0
Amine Gouiri,ALG,"MF,FW",Rennes,Ligue 1,24,2000,11.5,9,6,4,4,1,2,8,25,6,8,0,8,2,11,5,0
Lucas Gourna-Douath,FRA,MF,Roma,Serie A,20,2003,2.5,9,4,5,4,0,2,6,33.3,4,1,1,0,0,9,2,0
Jeffrey Gouweleeuw,NED,DF,Augsburg,Bundesliga,33,1991,32.7,50,28,25,21,4,27,40,67.5,13,34,15,19,35,85,183,0
Kamil Grabara,POL,GK,Wolfsburg,Bundesliga,25,1999,28.7,0,0,0,0,0,0,2,0,2,1,0,1,0,0,16,2
Jonathan Gradit,FRA,DF,Lens,Ligue 1,31,1992,23.5,44,23,22,19,3,23,40,57.5,17,27,12,15,25,69,122,2
José Gragera,ESP,MF,Espanyol,La Liga,23,2000,6.3,25,16,11,14,0,9,17,52.9,8,9,1,8,5,30,13,0
Samuel Grandsir,FRA,"MF,FW",Le Havre,Ligue 1,27,1996,0.9,5,5,0,3,2,2,3,66.7,1,2,0,2,0,5,0,0
Alberto Grassi,ITA,MF,Empoli,Serie A,29,1995,24.5,39,21,16,18,5,14,22,63.6,8,22,12,10,33,72,43,1
Ryan Gravenberch,NED,MF,Liverpool,Premier League,22,2002,35.1,69,35,27,29,13,32,56,57.1,24,35,10,25,60,129,59,2
Archie Gray,ENG,"DF,MF",Tottenham,Premier League,18,2006,19.5,16,8,4,8,4,7,17,41.2,10,22,11,11,19,35,50,2
Jack Grealish,ENG,"FW,MF",Manchester City,Premier League,28,1995,8,9,5,4,2,3,2,5,40,3,12,2,10,2,11,6,1
Jacob Greaves,ENG,DF,Ipswich Town,Premier League,23,2000,24.5,40,21,20,17,3,22,35,62.9,13,41,26,15,21,61,148,3
Mason Greenwood,ENG,"FW,MF",Marseille,Ligue 1,22,2001,31.2,35,18,10,14,11,16,39,41,23,7,0,7,12,47,5,2
Michael Gregoritsch,AUT,FW,Freiburg,Bundesliga,30,1994,7.1,4,2,1,0,3,1,5,20,4,2,1,1,1,5,10,0
Dominik Greif,SVK,GK,Mallorca,La Liga,27,1997,31,0,0,0,0,0,0,0,,0,0,0,0,0,0,13,1
Antoine Griezmann,FRA,"FW,MF",Atlético Madrid,La Liga,33,1991,27.4,30,17,13,13,4,7,29,24.1,22,20,1,19,6,36,23,1
Vincenzo Grifo,ITA,"FW,MF",Freiburg,Bundesliga,31,1993,27,30,22,12,13,5,15,34,44.1,19,24,2,22,9,39,23,2
Florian Grillitsch,AUT,MF,Valladolid,La Liga,28,1995,6.9,11,7,7,3,1,7,15,46.7,8,12,2,10,4,15,5,1
Florian Grillitsch,AUT,MF,Hoffenheim,Bundesliga,28,1995,6.7,15,9,5,9,1,8,14,57.1,6,6,2,4,8,23,18,0
Álex Grimaldo,ESP,DF,Leverkusen,Bundesliga,28,1995,29.3,24,14,13,7,4,16,42,38.1,26,22,3,19,16,40,43,3
Pascal Groß,GER,"MF,DF",Dortmund,Bundesliga,33,1991,25.9,44,28,11,26,7,15,51,29.4,36,46,13,33,9,53,30,1
Brajan Gruda,GER,"MF,FW",Brighton,Premier League,20,2004,7.6,16,8,6,6,4,7,14,50,7,8,0,8,2,18,5,1
Marco Grüll,AUT,"FW,MF",Werder Bremen,Bundesliga,26,1998,13.1,12,9,1,5,6,4,17,23.5,13,14,2,12,3,15,10,0
Albert Grønbaek,DEN,"FW,MF",Southampton,Premier League,23,2001,1.6,4,1,1,1,2,3,10,30,7,1,1,0,0,4,1,0
Albert Grønbaek,DEN,"MF,FW",Rennes,Ligue 1,23,2001,9,21,11,10,7,4,10,28,35.7,18,9,1,8,4,25,6,0
Vicente Guaita,ESP,GK,Celta Vigo,La Liga,37,1987,34,0,0,0,0,0,0,0,,0,0,0,0,0,0,21,3
Sergi Guardiola,ESP,FW,Rayo Vallecano,La Liga,33,1991,4,5,3,0,5,0,2,3,66.7,1,1,0,1,1,6,2,0
Nemanja Gudelj,SRB,"MF,DF",Sevilla,La Liga,32,1991,27.7,42,24,16,22,4,21,35,60,14,27,10,17,27,69,94,1
Gabriel Gudmundsson,SWE,DF,Lille,Ligue 1,25,1999,19.8,36,25,15,15,6,23,36,63.9,13,19,7,12,17,53,41,3
Gonçalo Guedes,POR,"MF,FW",Wolves,Premier League,27,1996,11.1,16,5,2,6,8,4,16,25,12,11,0,11,5,21,4,0
Axel Gueguin,FRA,FW,Montpellier,Ligue 1,19,2005,0.3,1,1,0,1,0,1,1,100,0,0,0,0,0,1,0,0
Marc Guéhi,ENG,DF,Crystal Palace,Premier League,24,2000,34,61,34,36,23,2,31,47,66,16,55,23,32,28,89,162,2
Mattéo Guendouzi,FRA,MF,Lazio,Serie A,25,1999,36.3,37,21,13,19,5,20,47,42.6,27,34,9,25,32,69,50,2
Javier Guerra,ESP,MF,Valencia,La Liga,21,2003,28.7,50,27,18,21,11,26,56,46.4,30,15,3,12,20,70,49,3
Raphaël Guerreiro,POR,"DF,MF",Bayern Munich,Bundesliga,30,1993,17.5,19,12,9,7,3,12,16,75,4,9,0,9,10,29,19,1
Evann Guessand,CIV,"FW,MF",Nice,Ligue 1,23,2001,28.5,44,29,12,15,17,6,14,42.9,8,27,3,24,15,59,16,0
Ander Guevara,ESP,MF,Alavés,La Liga,27,1997,21.6,49,30,19,29,1,20,48,41.7,28,21,5,16,14,63,43,1
Pape Gueye,SEN,MF,Villarreal,La Liga,25,1999,24.7,54,26,23,23,8,20,29,69,9,31,13,18,27,81,53,2
Morgan Guilavogui,GUI,"FW,MF",St. Pauli,Bundesliga,26,1998,20.1,32,17,11,16,5,14,31,45.2,17,28,0,28,13,45,33,0
Frederic Guilbert,FRA,DF,Lecce,Serie A,29,1994,27.1,65,36,30,29,6,36,55,65.5,19,28,8,20,47,112,113,3
Luis Guilherme,BRA,"MF,FW",West Ham,Premier League,18,2006,1.7,1,0,1,0,0,0,3,0,3,7,0,7,3,4,2,0
Hugo Guillamón,ESP,MF,Valencia,La Liga,24,2000,4,11,8,1,9,1,9,10,90,1,4,1,3,5,16,9,1
Bruno Guimarães,BRA,MF,Newcastle Utd,Premier League,26,1997,36.3,83,47,41,30,12,33,69,47.8,36,36,10,26,29,112,44,5
Carlos Guirao,ESP,MF,Betis,La Liga,21,2003,1.2,5,3,1,4,0,4,6,66.7,2,1,1,0,3,8,2,0
Bahereba Guirassy,FRA,"FW,MF",Nantes,Ligue 1,17,2006,3.9,12,8,6,3,3,7,13,53.8,6,10,0,10,1,13,4,0
Serhou Guirassy,GUI,FW,Dortmund,Bundesliga,28,1996,28.9,7,6,2,2,3,2,5,40,3,10,3,7,4,11,38,0
Marc Guiu,ESP,FW,Chelsea,Premier League,18,2006,0.8,1,1,0,1,0,1,1,100,0,0,0,0,0,1,0,0
Péter Gulácsi,HUN,GK,RB Leipzig,Bundesliga,34,1990,29.2,1,1,1,0,0,1,2,50,1,0,0,0,0,1,16,4
Arda Güler,TUR,"MF,FW",Real Madrid,La Liga,19,2005,13.9,30,16,11,8,11,9,22,40.9,13,18,0,18,7,37,8,0
Gerard Gumbau,ESP,MF,Rayo Vallecano,La Liga,29,1994,9.4,17,12,8,7,2,7,15,46.7,8,13,4,9,5,22,13,0
Robert Gumny,POL,DF,Augsburg,Bundesliga,26,1998,3,3,3,1,2,0,2,6,33.3,4,2,0,2,1,4,6,0
İlkay Gündoğan,GER,MF,Manchester City,Premier League,33,1990,24.7,25,13,5,15,5,10,24,41.7,14,15,0,15,13,38,23,0
Christian Günter,GER,DF,Freiburg,Bundesliga,31,1993,25.7,23,21,12,8,3,16,29,55.2,13,24,10,14,8,31,50,1
Jon Guridi,ESP,"MF,FW",Alavés,La Liga,29,1995,23.1,40,22,7,26,7,18,44,40.9,26,19,1,18,14,54,16,0
Gorka Guruzeta,ESP,FW,Athletic Club,La Liga,27,1996,20.4,16,8,1,13,2,7,31,22.6,24,28,4,24,9,25,23,0
Malo Gusto,FRA,DF,Chelsea,Premier League,21,2003,20.7,45,29,27,15,3,25,48,52.1,23,29,8,21,24,69,49,5
Miguel Gutiérrez,ESP,"DF,MF",Girona,La Liga,23,2001,27.3,37,24,18,16,3,17,37,45.9,20,17,7,10,16,53,34,3
Albert Guðmundsson,ISL,"FW,MF",Fiorentina,Serie A,27,1997,14.1,9,5,2,4,3,7,17,41.2,10,5,0,5,6,15,9,1
Joško Gvardiol,CRO,DF,Manchester City,Premier League,22,2002,36.4,58,39,25,21,12,21,40,52.5,19,42,20,22,44,102,122,8
Emmanuel Gyasi,GHA,"DF,FW",Empoli,Serie A,30,1994,35.7,52,29,32,14,6,24,38,63.2,14,27,9,18,11,63,77,0
Christian Gytkjær,DEN,FW,Venezia,Serie A,34,1990,8.4,6,4,2,2,2,1,2,50,1,3,1,2,0,6,8,0
Erling Haaland,NOR,FW,Manchester City,Premier League,24,2000,30.4,11,6,3,3,5,3,8,37.5,5,12,1,11,5,16,23,0
Nicolas Haas,SUI,MF,Empoli,Serie A,28,1996,3.2,11,8,4,5,2,5,9,55.6,4,2,1,1,4,15,6,0
Janik Haberer,GER,"MF,DF",Union Berlin,Bundesliga,30,1994,18.8,39,29,16,21,2,26,44,59.1,18,16,0,16,17,56,37,0
Robin Hack,GER,"FW,MF",Gladbach,Bundesliga,25,1998,24.1,22,17,11,8,3,12,28,42.9,16,30,2,28,9,31,28,0
Saad El Haddad,MAR,MF,Venezia,Serie A,19,2005,0.3,0,0,0,0,0,0,0,,0,0,0,0,0,0,0,0
Munir El Haddadi,MAR,"FW,MF",Leganés,La Liga,28,1995,9.6,12,9,5,4,3,3,12,25,9,8,1,7,1,13,1,1
Amadou Haidara,MLI,MF,RB Leipzig,Bundesliga,26,1998,14.7,30,17,12,16,2,12,29,41.4,17,42,12,30,18,48,56,1
Massadio Haïdara,MLI,DF,Brest,Ligue 1,31,1992,18.6,27,16,16,9,2,13,29,44.8,16,18,2,16,26,53,73,0
Antoine Hainaut,FRA,"DF,FW",Parma,Serie A,22,2002,13.4,26,14,15,8,3,9,13,69.2,4,17,4,13,15,41,59,1
Mohamed Haj,TUN,MF,Parma,Serie A,19,2005,5,3,1,2,1,0,1,2,50,1,3,1,2,4,7,5,0
Achraf Hakimi,MAR,DF,Paris S-G,Ligue 1,25,1998,23,48,36,18,20,10,27,55,49.1,28,25,2,23,31,79,18,3
Lewis Hall,ENG,DF,Newcastle Utd,Premier League,19,2004,24.3,58,41,28,22,8,40,74,54.1,34,33,18,15,18,76,75,3
Sébastien Haller,CIV,FW,Leganés,La Liga,30,1994,4.5,2,0,1,0,1,1,2,50,1,1,0,1,0,2,7,0
Ali Al Hamadi,IRQ,FW,Ipswich Town,Premier League,22,2002,1.5,1,0,0,0,1,0,2,0,2,0,0,0,0,1,2,0
Andreas Hanche-Olsen,NOR,DF,Mainz 05,Bundesliga,27,1997,14.3,21,13,12,8,1,9,12,75,3,25,18,7,12,33,85,2
Florent Hanin,ALG,DF,Angers,Ligue 1,34,1990,29.7,69,48,45,17,7,39,71,54.9,32,31,10,21,47,116,99,2
Ridgeciano Haps,SUR,DF,Venezia,Serie A,31,1993,15.2,30,16,19,8,3,14,22,63.6,8,18,3,15,7,37,48,0
Amine Harit,MAR,MF,Marseille,Ligue 1,27,1997,5.8,8,7,0,6,2,1,2,50,1,6,0,6,3,11,1,1
Marcus Harness,ENG,MF,Ipswich Town,Premier League,28,1996,0.5,1,0,0,0,1,0,3,0,3,2,1,1,0,1,1,0
Phil Harres,GER,FW,Holstein Kiel,Bundesliga,22,2002,17.2,10,10,3,4,3,4,8,50,4,17,3,14,5,15,20,0
Jack Harrison,ENG,FW,Everton,Premier League,27,1996,23.1,32,22,12,12,8,15,46,32.6,31,18,2,16,10,42,35,2
Abdou Harroui,NED,"MF,FW",Hellas Verona,Serie A,26,1998,5.1,9,6,6,3,0,4,4,100,0,5,0,5,2,11,5,0
Taylor Harwood-Bellis,ENG,DF,Southampton,Premier League,22,2002,31.4,28,20,13,12,3,19,35,54.3,16,65,43,22,30,58,141,6
Hans Hateboer,NED,DF,Rennes,Ligue 1,30,1994,18.7,31,16,14,12,5,18,36,50,18,19,6,13,29,60,64,2
Kjetil Haug,NOR,GK,Toulouse,Ligue 1,26,1998,5.5,0,0,0,0,0,0,0,,0,0,0,0,0,0,3,0
Kai Havertz,GER,"FW,MF",Arsenal,Premier League,25,1999,20.8,16,9,3,6,7,4,15,26.7,11,23,4,19,6,22,33,1
Ayden Heaven,ENG,DF,Manchester Utd,Premier League,17,2006,1.9,4,3,1,3,0,2,2,100,0,2,2,0,4,8,9,0
Jan Paul van Hecke,NED,DF,Brighton,Premier League,24,2000,32.9,45,29,24,19,2,23,41,56.1,18,37,22,15,24,69,142,2
Hwang Hee-chan,KOR,"MF,FW",Wolves,Premier League,28,1996,7.3,6,4,2,1,3,2,6,33.3,4,9,0,9,2,8,11,0
Dean Henderson,ENG,GK,Crystal Palace,Premier League,27,1997,38,2,1,2,0,0,2,6,33.3,4,0,0,0,0,2,22,0
Liam Henderson,SCO,MF,Empoli,Serie A,28,1996,26,42,22,17,22,3,22,53,41.5,31,19,5,14,15,57,42,0
Ramon Hendriks,NED,DF,Stuttgart,Bundesliga,23,2001,12.8,20,9,11,7,2,9,13,69.2,4,15,7,8,19,39,63,0
Paul Hennrich,GER,MF,Hoffenheim,Bundesliga,19,2005,0.1,0,0,0,0,0,0,0,,0,1,1,0,0,0,0,0
Benjamin Henrichs,GER,DF,RB Leipzig,Bundesliga,27,1997,10.4,32,16,18,10,4,14,27,51.9,13,22,3,19,15,47,33,0
Henrique,BRA,DF,Valladolid,La Liga,30,1994,3.9,6,2,3,2,1,1,4,25,3,5,0,5,3,9,12,0
Luis Henrique,BRA,"DF,FW",Marseille,Ligue 1,22,2001,29,16,9,7,6,3,9,10,90,1,15,2,13,10,26,30,0
Rico Henry,ENG,DF,Brentford,Premier League,27,1997,1.1,2,2,1,0,1,0,4,0,4,4,1,3,1,3,2,0
Mads Hermansen,DEN,GK,Leicester City,Premier League,24,2000,26.5,1,1,1,0,0,1,1,100,0,1,0,1,0,1,13,4
Mario Hermoso,ESP,DF,Roma,Serie A,29,1995,2.8,2,1,2,0,0,0,1,0,1,1,1,0,4,6,13,0
Mario Hermoso,ESP,DF,Leverkusen,Bundesliga,29,1995,3.3,0,0,0,0,0,0,0,,0,3,1,2,9,9,15,1
Javi Hernández,ESP,DF,Leganés,La Liga,26,1998,26.5,26,15,16,7,3,17,46,37,29,25,5,20,23,49,98,0
Aridane Hernández,ESP,DF,Rayo Vallecano,La Liga,35,1989,11.4,13,11,9,4,0,6,8,75,2,10,8,2,6,19,99,2
Lucas Hernández,FRA,DF,Paris S-G,Ligue 1,28,1996,9.7,24,18,13,9,2,14,23,60.9,9,12,5,7,7,31,37,2
Theo Hernández,FRA,DF,Milan,Serie A,26,1997,30,36,28,23,10,3,21,39,53.8,18,25,10,15,17,53,75,3
Hernani,BRA,MF,Parma,Serie A,30,1994,14.7,47,26,25,18,4,27,50,54,23,26,6,20,19,66,12,1
Jorge Herrando,ESP,DF,Osasuna,La Liga,23,2001,15.2,17,11,9,5,3,9,15,60,6,20,14,6,12,29,65,2
Ander Herrera,ESP,MF,Athletic Club,La Liga,34,1989,3,8,4,1,7,0,3,6,50,3,1,0,1,2,10,10,0
Sergio Herrera,ESP,GK,Osasuna,La Liga,31,1993,37,2,1,2,0,0,2,6,33.3,4,1,0,1,0,2,29,1
Yangel Herrera,VEN,MF,Girona,La Liga,26,1998,25.1,66,39,31,27,8,30,59,50.8,29,24,8,16,31,97,50,2
Juan Herzog,ESP,DF,Las Palmas,La Liga,21,2003,14.6,12,12,12,0,0,9,16,56.3,7,17,11,6,18,30,86,0
Son Heung-min,KOR,FW,Tottenham,Premier League,32,1992,23.4,17,9,3,8,6,5,27,18.5,22,11,0,11,5,22,17,1
Isak Hien,SWE,DF,Atalanta,Serie A,25,1999,25.9,48,28,27,21,0,27,44,61.4,17,31,18,13,31,79,82,2
Omar El Hilali,MAR,DF,Espanyol,La Liga,20,2003,35,111,79,81,24,6,64,95,67.4,31,53,13,40,46,157,145,2
James Hill,ENG,DF,Bournemouth,Premier League,22,2002,5,15,8,6,6,3,3,11,27.3,8,5,0,5,9,24,31,0
Piero Hincapié,ECU,DF,Leverkusen,Bundesliga,22,2002,29.7,52,40,27,15,10,25,41,61,16,40,20,20,32,84,114,1
Roger Hinojo,ESP,DF,Espanyol,La Liga,19,2005,0.1,0,0,0,0,0,0,0,,0,0,0,0,0,0,1,0
Jack Hinshelwood,ENG,"MF,DF",Brighton,Premier League,19,2005,20.5,27,19,8,10,9,11,27,40.7,16,10,3,7,16,43,37,1
George Hirst,SCO,FW,Ipswich Town,Premier League,25,1999,7.3,3,3,1,0,2,1,4,25,3,1,1,0,2,5,10,0
Adam Hložek,CZE,"FW,MF",Hoffenheim,Bundesliga,22,2002,20.8,22,10,7,8,7,11,20,55,9,13,1,12,4,26,20,0
Ki-Jana Hoever,NED,DF,Auxerre,Ligue 1,22,2002,23.6,51,38,26,16,9,30,54,55.6,24,33,3,30,21,72,70,1
Nicolas Höfler,GER,MF,Freiburg,Bundesliga,34,1990,8.8,33,23,13,18,2,20,31,64.5,11,7,1,6,14,47,28,1
Jonas Hofmann,GER,"MF,DF",Leverkusen,Bundesliga,32,1992,4,2,0,0,2,0,1,4,25,3,2,0,2,0,2,3,0
Philipp Hofmann,GER,FW,Bochum,Bundesliga,31,1993,25.3,17,12,4,6,7,8,15,53.3,7,14,1,13,4,21,33,0
Lucas Höler,GER,"FW,MF",Freiburg,Bundesliga,30,1994,20.7,37,24,18,15,4,9,24,37.5,15,29,7,22,7,44,36,0
Mason Holgate,JAM,"FW,DF",Everton,Premier League,27,1996,0.1,0,0,0,0,0,0,0,,0,0,0,0,0,0,0,0
Benedict Hollerbach,GER,"FW,MF",Union Berlin,Bundesliga,23,2001,28.2,43,22,8,23,12,21,51,41.2,30,35,0,35,2,45,13,1
Emil Holm,SWE,DF,Bologna,Serie A,24,2000,12.6,34,21,17,14,3,20,31,64.5,11,19,4,15,10,44,51,1
Lewis Holtby,GER,MF,Holstein Kiel,Bundesliga,33,1990,13.8,34,20,19,10,5,12,28,42.9,16,14,2,12,21,55,26,3
Gerrit Holtmann,PHI,"DF,FW",Bochum,Bundesliga,29,1995,12.6,24,19,14,8,2,12,24,50,12,18,5,13,16,40,15,0
Franck Honorat,FRA,FW,Gladbach,Bundesliga,27,1996,16,17,7,10,4,3,2,8,25,6,9,1,8,5,22,28,1
Mathias Honsak,AUT,"FW,DF",Heidenheim,Bundesliga,27,1996,13.1,15,8,10,5,0,10,23,43.5,13,19,4,15,10,25,31,0
Dinko Horkaš,CRO,GK,Las Palmas,La Liga,25,1999,12.1,0,0,0,0,0,0,0,,0,0,0,0,0,0,9,1
Timo Horn,GER,GK,Bochum,Bundesliga,31,1993,13,0,0,0,0,0,0,0,,0,0,0,0,0,0,9,2
Cédric Hountondji,BEN,DF,Angers,Ligue 1,30,1994,3,6,4,4,2,0,3,7,42.9,4,3,3,0,4,10,14,0
Ilyes Housni,FRA,"FW,MF",Le Havre,Ligue 1,19,2005,2.6,7,5,2,3,2,2,4,50,2,2,0,2,1,8,2,0
Harry Howell,ENG,FW,Brighton,Premier League,15,2008,0.1,1,1,1,0,0,1,2,50,1,1,0,1,0,1,0,0
Lukáš Hrádecký,FIN,GK,Leverkusen,Bundesliga,34,1989,29,0,0,0,0,0,0,1,0,1,0,0,0,0,0,8,2
Robin Hranáč,CZE,DF,Hoffenheim,Bundesliga,24,2000,2.4,0,0,0,0,0,0,1,0,1,3,2,1,5,5,9,1
Callum Hudson-Odoi,ENG,"FW,MF",Nott'ham Forest,Premier League,23,2000,24.4,22,14,8,8,6,12,18,66.7,6,11,0,11,13,35,12,1
Will Hughes,ENG,MF,Crystal Palace,Premier League,29,1995,23.4,66,36,20,33,13,28,62,45.2,34,31,14,17,21,87,28,3
Dean Huijsen,ESP,DF,Bournemouth,Premier League,19,2005,27,36,26,19,16,1,18,29,62.1,11,40,29,11,51,87,198,4
Mats Hummels,GER,DF,Roma,Serie A,35,1988,10.2,30,15,16,14,0,11,18,61.1,7,12,4,8,26,56,43,0
Omari Hutchinson,ENG,"MF,FW",Ipswich Town,Premier League,20,2003,28.7,32,13,14,10,8,13,48,27.1,35,27,2,25,11,43,15,1
Elseid Hysaj,ALB,DF,Lazio,Serie A,30,1994,4.7,11,6,6,5,0,3,3,100,0,5,2,3,5,16,21,0
Hong Hyunseok,KOR,MF,Mainz 05,Bundesliga,25,1999,5.9,8,3,3,3,2,1,4,25,3,7,1,6,7,15,9,0
Pierre Højbjerg,DEN,MF,Marseille,Ligue 1,28,1995,29.6,64,45,25,32,7,37,69,53.6,32,28,4,24,42,106,33,2
Oscar Højlund,DEN,MF,Eint Frankfurt,Bundesliga,19,2005,8,21,12,8,9,4,8,16,50,8,15,7,8,5,26,11,1
Rasmus Højlund,DEN,FW,Manchester Utd,Premier League,21,2003,22.3,3,1,0,2,1,0,5,0,5,6,0,6,2,5,6,0
Pablo Ibáñez,ESP,MF,Osasuna,La Liga,25,1998,14.4,20,10,7,12,1,10,40,25,30,20,7,13,18,38,21,0
Hafiz Ibrahim,NGA,FW,Reims,Ligue 1,18,2005,4.3,3,2,0,1,2,0,5,0,5,4,2,2,2,5,6,0
Arijon Ibrahimović,GER,MF,Lazio,Serie A,18,2005,0.1,0,0,0,0,0,0,0,,0,0,0,0,0,0,0,0
Arijon Ibrahimović,GER,FW,Bayern Munich,Bundesliga,18,2005,0,0,0,0,0,0,0,0,,0,0,0,0,0,0,0,0
Stanis Idumbo,BEL,"FW,MF",Sevilla,La Liga,19,2005,3.2,9,5,3,4,2,3,5,60,2,3,1,2,4,13,2,0
Jay Idzes,IDN,DF,Venezia,Serie A,24,2000,34.7,45,29,24,17,4,17,33,51.5,16,52,32,20,32,77,156,0
Iglesias,ESP,DF,Getafe,La Liga,26,1998,32.1,81,47,42,33,6,46,90,51.1,44,47,8,39,50,131,133,1
Borja Iglesias,ESP,FW,Celta Vigo,La Liga,31,1993,21.7,10,9,2,5,3,4,15,26.7,11,9,2,7,7,17,10,0
Igor,BRA,DF,Brighton,Premier League,26,1998,10.7,5,5,2,2,1,4,10,40,6,24,14,10,4,9,39,1
Kelechi Iheanacho,NGA,FW,Sevilla,La Liga,27,1996,4.4,1,0,0,1,0,1,3,33.3,2,0,0,0,0,1,1,0
Jonathan Ikone,FRA,FW,Como,Serie A,26,1998,6,15,9,4,3,8,6,11,54.5,5,5,1,4,0,15,1,1
Jonathan Ikone,FRA,"FW,MF",Fiorentina,Serie A,26,1998,3.7,5,2,3,2,0,2,4,50,2,3,0,3,1,6,1,0
George Ilenikhena,NGA,FW,Monaco,Ligue 1,17,2006,8,4,2,0,3,1,1,2,50,1,0,0,0,2,6,0,0
Andrej Ilic,SRB,FW,Union Berlin,Bundesliga,24,2000,10.4,2,2,0,2,0,0,6,0,6,7,3,4,5,7,6,1
Ivan Ilić,SRB,MF,Torino,Serie A,23,2001,10.2,5,2,0,4,1,2,8,25,6,0,0,0,5,10,10,0
Rareş Ilie,ROU,MF,Nice,Ligue 1,21,2003,0.1,1,1,1,0,0,1,1,100,0,0,0,0,0,1,0,0
Samuel Iling-Junior,ENG,"FW,MF",Bologna,Serie A,20,2003,1.3,3,2,1,1,1,0,1,0,1,1,0,1,2,5,2,0
Danny Ings,ENG,"FW,MF",West Ham,Premier League,32,1992,3.2,4,2,2,2,0,1,3,33.3,2,5,0,5,1,5,4,0
Alessio Iovine,ITA,"DF,FW",Como,Serie A,33,1991,4.3,5,2,2,3,0,4,10,40,6,7,1,6,3,8,21,1
Tim Iroegbunam,ENG,MF,Everton,Premier League,21,2003,6.4,29,14,14,10,5,14,23,60.9,9,18,4,14,16,45,12,1
Jackson Irvine,AUS,MF,St. Pauli,Bundesliga,31,1993,29,56,28,24,26,6,25,45,55.6,20,27,5,22,36,92,63,2
Andy Irving,SCO,MF,West Ham,Premier League,24,2000,1.8,7,4,3,3,1,1,5,20,4,5,1,4,1,8,5,0
Alexander Isak,SWE,FW,Newcastle Utd,Premier League,24,1999,30.6,12,5,2,3,7,5,15,33.3,10,18,2,16,3,15,17,1
Gustav Isaksen,DEN,FW,Lazio,Serie A,23,2001,24.6,16,9,7,8,1,7,28,25,21,22,2,20,10,26,21,1
Isco,ESP,MF,Betis,La Liga,32,1992,17.2,20,13,3,13,4,7,28,25,21,10,0,10,11,31,7,0
Ismaily,BRA,DF,Lille,Ligue 1,34,1990,10,33,17,17,12,4,17,26,65.4,9,15,1,14,13,46,49,0
Ardian Ismajli,ALB,DF,Empoli,Serie A,27,1996,27.9,30,23,21,9,0,16,20,80,4,35,24,11,56,86,249,3
Yanis Issoufou,FRA,"MF,FW",Montpellier,Ligue 1,17,2006,0.9,6,4,4,1,1,3,5,60,2,1,0,1,0,6,1,0
Ko Itakura,JPN,DF,Gladbach,Bundesliga,27,1997,31,40,29,23,16,1,21,34,61.8,13,41,22,19,28,68,171,0
Hiroki Ito,JPN,DF,Bayern Munich,Bundesliga,25,1999,2.8,2,0,1,1,0,1,1,100,0,3,2,1,6,8,15,1
Junya Ito,JPN,"FW,MF",Reims,Ligue 1,31,1993,29.9,45,30,19,16,10,17,60,28.3,43,33,3,30,13,58,15,2
Diego Iturralde,ESP,FW,Sevilla,La Liga,21,2003,0.4,0,0,0,0,0,0,0,,0,0,0,0,1,1,1,0
Marko Ivezić,SRB,DF,Holstein Kiel,Bundesliga,22,2001,18.4,29,19,20,6,3,15,42,35.7,27,25,13,12,27,56,103,2
Alex Iwobi,NGA,"FW,MF",Fulham,Premier League,28,1996,33.1,44,25,14,21,9,22,34,64.7,12,26,1,25,14,58,29,1
Armando Izzo,ITA,DF,Monza,Serie A,32,1992,27.1,40,15,30,9,1,18,36,50,18,38,28,10,45,85,101,0
Fellipe Jack,BRA,DF,Como,Serie A,18,2006,1.9,9,4,8,1,0,3,5,60,2,2,2,0,4,13,5,0
Nicolas Jackson,SEN,FW,Chelsea,Premier League,23,2001,24.7,22,13,6,7,9,5,10,50,5,15,2,13,3,25,15,0
Jérémy Jacquet,FRA,DF,Rennes,Ligue 1,19,2005,10.3,26,17,11,8,7,14,22,63.6,8,9,3,6,27,53,45,1
Lee Jae-sung,KOR,MF,Mainz 05,Bundesliga,31,1992,29.4,42,21,16,19,7,15,39,38.5,24,39,3,36,35,77,38,0
Ivan Jaime Pajuelo,ESP,MF,Valencia,La Liga,23,2000,3.3,8,5,2,3,3,4,5,80,1,2,0,2,2,10,0,0
Kristijan Jakić,CRO,MF,Augsburg,Bundesliga,27,1997,25.6,46,23,20,19,7,22,43,51.2,21,42,9,33,28,74,50,1
Karl Jakob Hein,EST,GK,Valladolid,La Liga,22,2002,31,0,0,0,0,0,0,2,0,2,0,0,0,0,0,19,2
Ismail Jakobs,SEN,DF,Monaco,Ligue 1,24,1999,2,5,5,3,0,2,3,5,60,2,0,0,0,2,7,6,0
Jordan James,WAL,MF,Rennes,Ligue 1,20,2004,13.1,30,19,8,18,4,16,30,53.3,14,14,1,13,14,44,17,1
Reece James,ENG,"DF,MF",Chelsea,Premier League,24,1999,11.8,10,9,6,3,1,3,9,33.3,6,14,6,8,13,23,23,4
Vitaly Janelt,GER,MF,Brentford,Premier League,26,1998,25,38,22,14,13,11,21,36,58.3,15,33,9,24,27,65,53,1
Adnan Januzaj,BEL,"MF,FW",Las Palmas,La Liga,29,1995,6.6,10,6,1,6,3,5,9,55.6,4,6,0,6,2,12,3,0
Luca Jaquez,SUI,DF,Stuttgart,Bundesliga,21,2003,2.8,3,0,3,0,0,1,3,33.3,2,2,0,2,3,6,4,0
Vitezslav Jaros,CZE,GK,Liverpool,Premier League,23,2001,0.1,0,0,0,0,0,0,0,,0,0,0,0,0,0,0,0
Ali Jasim,IRQ,"FW,DF",Como,Serie A,20,2004,0.1,1,0,1,0,0,1,1,100,0,0,0,0,0,1,0,0
Mikel Jauregizar,ESP,MF,Athletic Club,La Liga,20,2003,24.9,84,48,25,45,14,41,83,49.4,42,24,4,20,29,113,36,2
Dominik Javorček,SVK,"DF,MF",Holstein Kiel,Bundesliga,21,2002,4.3,3,0,3,0,0,1,5,20,4,7,3,4,5,8,26,1
Gaby Jean,FRA,DF,Lecce,Serie A,24,2000,15.4,14,7,8,5,1,6,11,54.5,5,13,10,3,9,23,71,1
Daniel Jebbison,ENG,FW,Bournemouth,Premier League,20,2003,1.3,5,3,3,2,0,4,6,66.7,2,2,1,1,1,6,1,0
Finn Jeltsch,GER,DF,Stuttgart,Bundesliga,18,2006,8.7,18,13,6,11,1,12,15,80,3,12,6,6,13,31,27,2
Malcolm Jeng,SWE,DF,Reims,Ligue 1,19,2005,1.2,0,0,0,0,0,0,0,,0,1,0,1,3,3,10,0
Fredrik Jensen,FIN,MF,Augsburg,Bundesliga,26,1997,8.5,7,7,1,3,3,4,5,80,1,10,1,9,4,11,17,0
Mathias Jensen,DEN,MF,Brentford,Premier League,28,1996,9.6,14,10,6,6,2,8,16,50,8,15,4,11,8,22,13,2
Moritz Jenz,GER,DF,Mainz 05,Bundesliga,25,1999,17.8,36,20,18,18,0,16,21,76.2,5,23,14,9,30,66,128,2
Gabriel Jesus,BRA,FW,Arsenal,Premier League,27,1997,6.8,10,6,4,3,3,4,9,44.4,5,10,1,9,4,14,8,0
Juan Jesus,BRA,DF,Napoli,Serie A,33,1991,11.9,25,14,16,9,0,12,20,60,8,15,3,12,9,34,42,0
Alejandro Jiménez,ESP,"DF,FW",Milan,Serie A,19,2005,14.1,24,13,8,14,2,11,27,40.7,16,24,3,21,15,39,23,0
Raúl Jiménez,MEX,FW,Fulham,Premier League,33,1991,27.7,35,24,9,17,9,8,22,36.4,14,21,5,16,10,45,23,3
Kim Jisoo,KOR,DF,Brentford,Premier League,19,2004,0.3,0,0,0,0,0,0,0,,0,0,0,0,0,0,2,0
João Pedro,BRA,"FW,MF",Brighton,Premier League,22,2001,21.6,16,12,6,6,4,4,11,36.4,7,12,0,12,9,25,12,0
John Joe,IRL,"MF,FW",Getafe,La Liga,20,2003,0.5,0,0,0,0,0,0,0,,0,1,1,0,0,0,1,0
John Joe,IRL,MF,Reims,Ligue 1,20,2003,6.1,24,15,11,10,3,7,19,36.8,12,11,2,9,6,30,9,0
Joelinton,BRA,"MF,FW",Newcastle Utd,Premier League,27,1996,26.6,57,35,23,23,11,25,44,56.8,19,37,7,30,23,80,47,2
Jofre,ESP,"MF,FW",Espanyol,La Liga,23,2001,24.1,22,16,14,5,3,13,23,56.5,10,13,0,13,15,37,29,0
Þórir Jóhann Helgason,ISL,MF,Lecce,Serie A,23,2000,12.8,10,7,3,6,1,7,13,53.8,6,7,2,5,6,16,11,2
Carl Johansson,SWE,DF,Holstein Kiel,Bundesliga,30,1994,6.3,4,2,4,0,0,3,7,42.9,4,12,8,4,10,14,54,1
Ben Johnson,ENG,"DF,FW",Ipswich Town,Premier League,24,2000,15,38,22,23,12,3,20,41,48.8,21,22,5,17,13,51,54,1
Brennan Johnson,WAL,FW,Tottenham,Premier League,23,2001,24.2,39,26,9,20,10,16,34,47.1,18,25,3,22,4,43,14,0
Karl-Johan Johnsson,SWE,GK,Strasbourg,Ligue 1,34,1990,3,0,0,0,0,0,0,1,0,1,0,0,0,0,0,3,0
Sam Johnstone,ENG,GK,Wolves,Premier League,31,1993,7,0,0,0,0,0,0,1,0,1,0,0,0,0,0,7,0
Paul Joly,FRA,DF,Auxerre,Ligue 1,24,2000,11.2,49,32,30,17,2,27,45,60,18,19,1,18,25,74,32,5
Curtis Jones,ENG,"MF,DF",Liverpool,Premier League,23,2001,19,39,22,6,23,10,17,27,63,10,22,9,13,7,46,10,3
Frenkie de Jong,NED,MF,Barcelona,La Liga,27,1997,12.7,19,11,5,8,6,8,16,50,8,9,1,8,12,31,7,1
Joan Jordán,ESP,MF,Alavés,La Liga,30,1994,15.7,32,18,11,17,4,17,30,56.7,13,12,0,12,9,41,21,0
Jorginho,ITA,MF,Arsenal,Premier League,32,1991,7.8,12,4,1,7,4,8,20,40,12,3,0,3,7,19,2,2
Jesse Joronen,FIN,GK,Venezia,Serie A,31,1993,7.8,0,0,0,0,0,0,0,,0,0,0,0,0,0,4,1
Jota,POR,"FW,MF",Rennes,Ligue 1,25,1999,3.7,5,2,2,3,0,4,7,57.1,3,1,0,1,3,8,2,0
Diogo Jota,POR,FW,Liverpool,Premier League,27,1996,13.3,14,8,2,8,4,7,19,36.8,12,9,0,9,8,22,6,0
Antoine Joujou,FRA,"MF,FW",Le Havre,Ligue 1,21,2003,10.5,16,11,10,4,2,9,15,60,6,15,3,12,9,25,19,0
Luka Jović,SRB,"FW,MF",Milan,Serie A,26,1997,6.2,0,0,0,0,0,0,0,,0,2,1,1,1,1,3,0
Juanmi,ESP,"FW,MF",Getafe,La Liga,31,1993,7.7,14,11,4,7,3,6,19,31.6,13,6,0,6,2,16,3,0
Juanmi,ESP,"FW,MF",Betis,La Liga,31,1993,2.7,7,4,3,3,1,4,6,66.7,2,4,0,4,1,8,4,0
Juanpe,ESP,DF,Girona,La Liga,33,1991,8.1,8,5,5,3,0,6,8,75,2,15,10,5,8,16,56,1
Jubal,BRA,DF,Auxerre,Ligue 1,30,1993,29.3,60,39,46,13,1,28,40,70,12,61,36,25,25,85,201,1
Anthony Jung,GER,DF,Werder Bremen,Bundesliga,32,1991,21.1,34,22,22,11,1,22,34,64.7,12,23,14,9,25,59,77,1
Luiz Lúcio Reis Júnior,BRA,GK,Villarreal,La Liga,23,2001,16.2,0,0,0,0,0,0,0,,0,0,0,0,0,0,14,1
Hamed Junior Traorè,CIV,MF,Auxerre,Ligue 1,24,2000,23.3,41,20,11,17,13,16,54,29.6,38,14,0,14,8,49,11,0
Vinicius Júnior,BRA,FW,Real Madrid,La Liga,24,2000,25,21,10,7,4,10,5,18,27.8,13,9,0,9,3,24,1,2
Josip Juranović,CRO,"DF,MF",Union Berlin,Bundesliga,28,1995,12.9,21,13,12,6,3,10,25,40,15,13,6,7,7,28,42,2
David Jurásek,CZE,DF,Hoffenheim,Bundesliga,23,2000,6.9,6,3,3,2,1,2,5,40,3,5,0,5,6,12,17,0
Stanko Jurić,CRO,MF,Valladolid,La Liga,27,1996,19.2,48,24,26,19,3,19,48,39.6,29,35,11,24,24,72,52,0
James Justin,ENG,DF,Leicester City,Premier League,26,1998,32.4,58,37,29,23,6,32,55,58.2,23,48,17,31,46,104,141,3
Filip Jørgensen,DEN,GK,Chelsea,Premier League,22,2002,6,0,0,0,0,0,0,0,,0,0,0,0,0,0,0,3
Mohamed Kaba,FRA,MF,Lecce,Serie A,22,2001,5,13,8,7,5,1,8,10,80,2,11,4,7,4,17,10,1
Yusuf Kabadayı,GER,"FW,MF",Augsburg,Bundesliga,20,2004,0.8,1,0,0,1,0,0,0,,0,1,0,1,0,1,0,0
Almugera Kabar,GER,DF,Dortmund,Bundesliga,18,2006,1.5,5,3,2,2,1,3,3,100,0,1,0,1,1,6,4,0
Christian Kabasele,BEL,DF,Udinese,Serie A,33,1991,12.9,17,9,10,7,0,11,14,78.6,3,14,8,6,14,31,75,1
Issa Kaboré,BFA,"DF,FW",Werder Bremen,Bundesliga,23,2001,3.4,8,4,2,5,1,4,6,66.7,2,8,2,6,2,10,7,0
Yaya Kader Fofana,MLI,"MF,FW",Reims,Ligue 1,20,2004,7,17,11,8,5,4,4,12,33.3,8,11,2,9,3,20,2,0
Pavel Kadeřábek,CZE,DF,Hoffenheim,Bundesliga,32,1992,17.5,25,14,14,4,7,15,31,48.4,16,13,3,10,20,45,54,1
Tino Kadewere,ZIM,"MF,FW",Nantes,Ligue 1,28,1996,5.7,14,8,5,3,6,6,13,46.2,7,3,0,3,6,20,8,0
Ferdi Kadioglu,TUR,"DF,MF",Brighton,Premier League,24,1999,4.3,10,6,4,5,1,6,15,40,9,2,2,0,8,18,17,0
Arnaud Kalimuendo,FRA,"FW,MF",Rennes,Ligue 1,22,2002,28.6,19,12,6,9,4,7,15,46.7,8,9,2,7,4,23,16,1
Pierre Kalulu,FRA,DF,Juventus,Serie A,24,2000,26,41,25,29,9,3,18,24,75,6,27,15,12,17,58,68,1
Justin-Noël Kalumba,FRA,"FW,MF",Angers,Ligue 1,19,2004,0.3,0,0,0,0,0,0,0,,0,0,0,0,1,1,1,0
Daichi Kamada,JPN,MF,Crystal Palace,Premier League,27,1996,17.4,47,29,19,24,4,14,41,34.1,27,22,5,17,18,65,14,0
Waren Kamanzi,NOR,"DF,MF",Toulouse,Ligue 1,23,2000,11.4,29,13,12,12,5,14,28,50,14,7,3,4,9,38,25,0
Boubacar Kamara,FRA,MF,Aston Villa,Premier League,24,1999,19.2,50,21,28,18,4,29,56,51.8,27,19,7,12,19,69,51,3
Glen Kamara,FIN,MF,Rennes,Ligue 1,28,1995,7.4,23,11,10,11,2,11,17,64.7,6,7,0,7,7,30,7,0
Hassane Kamara,CIV,DF,Udinese,Serie A,30,1994,22.2,35,25,20,11,4,16,28,57.1,12,23,5,18,26,61,49,1
Noham Kamara,FRA,DF,Paris S-G,Ligue 1,17,2007,0.8,1,1,0,1,0,0,0,,0,1,1,0,1,2,1,0
Willy Kambwala,FRA,DF,Villarreal,La Liga,19,2004,12.4,17,12,14,2,1,10,12,83.3,2,10,7,3,10,27,56,1
Jakub Kamiński,POL,"DF,MF",Wolfsburg,Bundesliga,22,2002,12.6,17,8,8,3,6,9,22,40.9,13,17,7,10,13,30,23,1
Kevin Kampl,SVN,MF,RB Leipzig,Bundesliga,33,1990,17.7,27,18,11,10,6,16,26,61.5,10,25,6,19,24,51,25,0
Nordine Kandil,FRA,MF,Strasbourg,Ligue 1,22,2001,0.1,0,0,0,0,0,0,0,,0,0,0,0,0,0,1,0
Harry Kane,ENG,FW,Bayern Munich,Bundesliga,31,1993,26.5,13,11,3,8,2,2,6,33.3,4,16,2,14,2,15,16,0
Lee Kang-in,KOR,"FW,MF",Paris S-G,Ligue 1,23,2001,18.5,25,17,7,11,7,19,35,54.3,16,11,1,10,3,28,3,1
Yann Karamoh,FRA,"MF,FW",Torino,Serie A,26,1998,11.6,5,2,2,1,2,4,9,44.4,5,10,2,8,3,8,5,0
Atakan Karazor,,MF,Stuttgart,Bundesliga,27,1996,29.1,59,29,19,28,12,29,57,50.9,28,39,7,32,32,91,51,1
Jesper Karlsson,SWE,FW,Bologna,Serie A,26,1998,3.3,1,0,0,0,1,0,2,0,2,4,0,4,0,1,3,0
Jesper Karlsson,SWE,FW,Lecce,Serie A,26,1998,5.5,3,2,3,0,0,2,8,25,6,2,0,2,0,3,4,0
Jesper Karlström,SWE,MF,Udinese,Serie A,29,1995,35.4,61,34,32,21,8,25,51,49,26,28,11,17,35,96,82,5
Lior Kasa,ISR,"MF,FW",Genoa,Serie A,18,2005,2.6,4,4,2,2,0,2,5,40,3,4,1,3,3,7,5,0
Grigoris Kastanos,CYP,"MF,FW",Hellas Verona,Serie A,26,1998,9.7,23,16,8,7,8,9,21,42.9,12,17,2,15,7,30,8,0
Mikkel Kaufmann,DEN,FW,Heidenheim,Bundesliga,23,2001,4.1,6,4,1,3,2,2,5,40,3,5,2,3,2,8,7,0
Joachim Kayi Sanda,FRA,DF,Southampton,Premier League,17,2006,0.2,0,0,0,0,0,0,0,,0,0,0,0,2,2,0,0
Michael Kayode,ITA,DF,Brentford,Premier League,20,2004,5.9,17,11,12,5,0,9,13,69.2,4,3,0,3,7,24,19,0
Michael Kayode,ITA,"DF,FW",Fiorentina,Serie A,20,2004,1.4,1,1,1,0,0,0,0,,0,3,1,2,2,3,7,0
Moise Kean,ITA,FW,Fiorentina,Serie A,24,2000,29.1,7,5,1,2,4,3,4,75,1,12,0,12,5,12,26,1
Michael Keane,ENG,DF,Everton,Premier League,31,1993,11.7,12,9,8,2,2,8,15,53.3,7,14,10,4,16,28,65,2
Yassine Kechta,MAR,"MF,FW",Le Havre,Ligue 1,22,2002,23.3,60,36,32,21,7,33,78,42.3,45,25,2,23,26,86,32,2
Thilo Kehrer,GER,DF,Monaco,Ligue 1,27,1996,26.5,37,23,26,11,0,22,38,57.9,16,18,10,8,36,73,113,1
Abdoulaye Keita,ESP,"FW,MF",Getafe,La Liga,21,2002,1.1,2,2,0,1,1,2,4,50,2,1,0,1,0,2,3,0
Mandela Keita,BEL,MF,Parma,Serie A,22,2002,20.3,44,25,13,25,6,18,35,51.4,17,18,7,11,21,65,29,2
Yannik Keitel,GER,MF,Stuttgart,Bundesliga,24,2000,3,9,6,3,5,1,9,10,90,1,5,2,3,4,13,6,0
Andu Kelati,GER,"MF,DF",Holstein Kiel,Bundesliga,21,2002,3.2,7,4,2,4,1,2,5,40,3,4,1,3,3,10,3,0
Caoimhín Kelleher,IRL,GK,Liverpool,Premier League,25,1998,10,0,0,0,0,0,0,0,,0,0,0,0,0,0,1,2
Thomas Keller,GER,"DF,MF",Heidenheim,Bundesliga,24,1999,1.6,6,5,5,1,0,4,6,66.7,2,3,1,2,4,10,11,0
Lloyd Kelly,ENG,DF,Newcastle Utd,Premier League,25,1998,3.4,5,4,4,1,0,1,1,100,0,6,4,2,1,6,17,0
Lloyd Kelly,ENG,DF,Juventus,Serie A,25,1998,11.3,15,11,5,9,1,7,9,77.8,2,11,6,5,2,17,56,3
Aljoscha Kemlein,GER,MF,Union Berlin,Bundesliga,19,2004,10.2,10,4,4,5,1,5,14,35.7,9,14,3,11,6,16,15,0
Marc-Oliver Kempf,GER,DF,Como,Serie A,29,1995,29.1,30,20,15,14,1,13,24,54.2,11,35,26,9,33,63,136,4
Kenedy,BRA,"MF,FW",Valladolid,La Liga,28,1996,0.1,0,0,0,0,0,0,0,,0,1,0,1,0,0,0,0
Luca Kerber,GER,"MF,DF",Heidenheim,Bundesliga,22,2002,8.7,26,16,17,8,1,16,31,51.6,15,14,4,10,5,31,25,1
Milos Kerkez,HUN,DF,Bournemouth,Premier League,20,2003,37.1,52,26,25,20,7,24,38,63.2,14,38,11,27,45,97,106,4
Reda Khadra,GER,"MF,FW",Reims,Ligue 1,23,2001,0.9,1,1,1,0,0,0,1,0,1,0,0,0,0,1,1,0
Bilal El Khannouss,MAR,"MF,FW",Leicester City,Premier League,20,2004,24.2,50,30,16,29,5,17,32,53.1,15,22,4,18,6,56,10,3
Wahbi Khazri,TUN,"FW,MF",Montpellier,Ligue 1,33,1991,12.4,25,18,5,16,4,8,21,38.1,13,13,1,12,5,30,7,0
Rani Khedira,GER,MF,Union Berlin,Bundesliga,30,1994,30.3,68,40,30,35,3,24,38,63.2,14,33,11,22,44,112,55,0
Abdukodir Khusanov,UZB,DF,Manchester City,Premier League,20,2004,5.6,5,4,4,1,0,2,3,66.7,1,5,4,1,3,8,29,1
Abdukodir Khusanov,UZB,DF,Lens,Ligue 1,20,2004,10.8,15,11,9,5,1,7,11,63.6,4,17,11,6,26,41,57,0
Kialonda,ANG,DF,Lecce,Serie A,26,1997,23.8,34,12,24,10,0,12,17,70.6,5,44,28,16,32,66,132,1
Kiké,ESP,FW,Alavés,La Liga,34,1989,28.2,19,14,1,12,6,6,17,35.3,11,11,4,7,1,20,23,0
Max Kilman,ENG,DF,West Ham,Premier League,27,1997,37.2,39,24,16,20,3,23,27,85.2,4,58,40,18,38,77,212,6
Joshua Kimmich,GER,MF,Bayern Munich,Bundesliga,29,1995,31.6,47,29,11,29,7,30,50,60,20,23,3,20,25,72,34,3
Presnel Kimpembe,FRA,DF,Paris S-G,Ligue 1,28,1995,0.3,1,0,1,0,0,0,0,,0,2,2,0,0,1,1,0
Joshua King,ENG,MF,Fulham,Premier League,17,2007,1.4,7,5,3,4,0,0,3,0,3,3,0,3,1,8,1,0
Joshua King,NOR,"FW,MF",Toulouse,Ligue 1,32,1992,18.6,11,11,4,4,3,5,12,41.7,7,10,3,7,6,17,19,0
Tom King,WAL,GK,Wolves,Premier League,29,1995,0,0,0,0,0,0,0,0,,0,0,0,0,0,0,0,0
Antonín Kinský,CZE,GK,Tottenham,Premier League,21,2003,6,3,1,3,0,0,1,1,100,0,0,0,0,0,3,9,1
Cédric Kipré,CIV,DF,Reims,Ligue 1,27,1996,24.3,42,30,30,11,1,29,39,74.4,10,42,27,15,32,74,162,2
Jakub Kiwior,POL,DF,Arsenal,Premier League,24,2000,12.5,22,8,13,7,2,11,15,73.3,4,13,8,5,6,28,58,3
Tim Kleindienst,GER,FW,Gladbach,Bundesliga,28,1995,30.4,30,15,6,15,9,10,35,28.6,25,45,9,36,12,42,66,1
Lukas Klostermann,GER,DF,RB Leipzig,Bundesliga,28,1996,20.4,27,14,18,7,2,14,24,58.3,10,31,17,14,24,51,143,3
Justin Kluivert,NED,MF,Bournemouth,Premier League,25,1999,26,23,11,4,11,8,4,22,18.2,18,24,0,24,14,37,24,1
Ansgar Knauff,GER,"MF,DF",Eint Frankfurt,Bundesliga,22,2002,17.7,41,22,18,16,7,12,26,46.2,14,23,4,19,12,53,24,0
Magnus Knudsen,NOR,MF,Holstein Kiel,Bundesliga,23,2001,20.6,48,29,21,21,6,25,44,56.8,19,18,4,14,12,60,44,0
Gregor Kobel,SUI,GK,Dortmund,Bundesliga,26,1997,32,0,0,0,0,0,0,0,,0,0,0,0,1,1,23,3
Robin Koch,GER,DF,Eint Frankfurt,Bundesliga,28,1996,28.7,24,11,14,8,2,10,22,45.5,12,39,25,14,25,49,197,4
Hervé Koffi,BFA,GK,Lens,Ligue 1,27,1996,5,1,1,1,0,0,1,1,100,0,0,0,0,0,1,5,0
Magnus Kofod Andersen,DEN,MF,Venezia,Serie A,25,1999,7.7,13,4,3,9,1,4,10,40,6,7,2,5,6,19,12,0
Derrick Köhn,GER,"DF,FW",Werder Bremen,Bundesliga,25,1999,14.9,20,10,7,10,3,10,14,71.4,4,21,4,17,10,30,26,0
Philipp Köhn,SUI,GK,Monaco,Ligue 1,26,1998,19,0,0,0,0,0,0,1,0,1,0,0,0,0,0,11,2
Dominik Kohr,GER,"DF,MF",Mainz 05,Bundesliga,30,1994,25.5,62,46,34,21,7,35,55,63.6,20,43,24,19,42,104,127,0
Koka,EGY,FW,Le Havre,Ligue 1,31,1993,9.5,4,1,1,3,0,0,4,0,4,3,0,3,4,8,6,1
Koke,ESP,MF,Atlético Madrid,La Liga,32,1992,21.4,46,23,18,22,6,21,43,48.8,22,24,2,22,20,66,29,2
Sead Kolašinac,BIH,DF,Atalanta,Serie A,31,1993,21.1,41,26,21,20,0,16,30,53.3,14,16,7,9,25,66,53,1
Randal Kolo Muani,FRA,FW,Juventus,Serie A,25,1998,12.9,11,7,3,5,3,4,5,80,1,8,0,8,4,15,2,0
Randal Kolo Muani,FRA,FW,Paris S-G,Ligue 1,25,1998,4,4,4,1,1,2,0,2,0,2,1,0,1,0,4,5,0
Marco Komenda,CRO,DF,Holstein Kiel,Bundesliga,27,1996,14.5,26,17,12,13,1,11,15,73.3,4,23,11,12,6,32,68,0
Mert Kömür,GER,MF,Augsburg,Bundesliga,19,2005,7.3,3,2,2,0,1,0,3,0,3,9,3,6,3,6,7,1
Ibrahima Konaté,FRA,DF,Liverpool,Premier League,25,1999,28.4,40,26,25,13,2,25,35,71.4,10,29,15,14,17,57,133,3
Ismael Konate,CIV,"FW,MF",Empoli,Serie A,18,2006,1.3,4,2,4,0,0,2,3,66.7,1,3,2,1,0,4,1,0
Geoffrey Kondogbia,CTA,"DF,MF",Marseille,Ligue 1,31,1993,22.4,60,38,31,26,3,27,34,79.4,7,23,6,17,22,82,64,4
Abdoul Koné,FRA,DF,Reims,Ligue 1,19,2005,1.5,5,3,4,1,0,3,5,60,2,2,1,1,1,6,5,0
Amadou Koné,MLI,MF,Reims,Ligue 1,19,2005,14.4,49,32,32,16,1,22,35,62.9,13,18,4,14,19,68,38,2
Ismaël Koné,CAN,"MF,FW",Marseille,Ligue 1,22,2002,4,8,4,3,3,2,3,4,75,1,4,1,3,4,12,2,1
Ismaël Koné,CAN,MF,Rennes,Ligue 1,22,2002,5.2,9,6,4,4,1,5,7,71.4,2,9,2,7,4,13,5,0
Manu Koné,FRA,MF,Roma,Serie A,23,2001,28.6,41,26,17,17,7,19,40,47.5,21,27,4,23,24,65,28,0
Ezri Konsa,ENG,DF,Aston Villa,Premier League,26,1997,32.6,34,18,20,10,4,20,25,80,5,20,11,9,24,58,114,4
Teun Koopmeiners,NED,"MF,FW",Juventus,Serie A,26,1998,22.2,32,16,6,19,7,10,30,33.3,20,36,14,22,8,40,26,2
Kacper Koscierski,GER,DF,Bochum,Bundesliga,17,2007,0.1,0,0,0,0,0,0,0,,0,0,0,0,0,0,0,0
Odilon Kossounou,CIV,DF,Atalanta,Serie A,23,2001,12.5,16,11,8,6,2,6,13,46.2,7,16,6,10,13,29,25,1
Christian Kouamé,CIV,"FW,MF",Fiorentina,Serie A,26,1997,6.9,13,8,4,4,5,0,3,0,3,3,1,2,2,15,10,0
Christian Kouamé,CIV,"FW,MF",Empoli,Serie A,26,1997,5.6,5,4,0,3,2,2,4,50,2,4,2,2,0,5,4,0
Henri Koudossou,GER,DF,Augsburg,Bundesliga,24,1999,8.3,18,10,6,11,1,11,19,57.9,8,8,2,6,15,33,37,0
Konstantinos Koulierakis,GRE,DF,Wolfsburg,Bundesliga,20,2003,27.4,40,20,25,13,2,25,40,62.5,15,34,14,20,33,73,147,2
Emmanuel Koum Mbondo,FRA,DF,Marseille,Ligue 1,18,2006,0.1,0,0,0,0,0,0,0,,0,0,0,0,0,0,0,0
Jules Koundé,FRA,DF,Barcelona,La Liga,25,1998,28.9,63,43,29,23,11,44,66,66.7,22,35,5,30,20,83,68,2
Boubakar Kouyaté,MLI,DF,Montpellier,Ligue 1,27,1997,8.4,22,17,16,6,0,11,19,57.9,8,17,11,6,12,34,54,0
Mateo Kovačić,CRO,MF,Manchester City,Premier League,30,1994,24.4,69,38,23,38,8,31,65,47.7,34,20,0,20,24,93,21,1
Viktor Kovalenko,UKR,MF,Empoli,Serie A,28,1996,0.9,2,1,0,2,0,0,1,0,1,0,0,0,0,2,0,0
Matej Kovar,CZE,GK,Leverkusen,Bundesliga,24,2000,5,0,0,0,0,0,0,0,,0,0,0,0,0,0,0,1
Mateusz Kowalski,POL,MF,Parma,Serie A,19,2005,0.6,0,0,0,0,0,0,0,,0,1,0,1,0,0,1,0
Goduine Koyalipou,CTA,FW,Lens,Ligue 1,24,2000,9.8,3,2,0,3,0,1,1,100,0,4,0,4,1,4,8,0
Caleb Kporha,ENG,DF,Crystal Palace,Premier League,18,2006,0.1,2,1,2,0,0,2,2,100,0,0,0,0,0,2,1,0
Emil Krafth,SWE,DF,Newcastle Utd,Premier League,29,1994,3.8,4,2,2,1,1,2,3,66.7,1,5,4,1,2,6,16,0
Alex Král,CZE,MF,Espanyol,La Liga,26,1998,30.2,55,37,28,24,3,16,30,53.3,14,34,14,20,28,83,51,2
Andrej Kramarić,CRO,"MF,FW",Hoffenheim,Bundesliga,33,1991,30.7,15,8,5,8,2,6,11,54.5,5,16,3,13,7,22,11,1
Frans Krätzig,GER,"DF,MF",Heidenheim,Bundesliga,21,2003,13.5,32,18,14,12,6,12,21,57.1,9,12,1,11,17,49,15,0
Frans Krätzig,GER,DF,Stuttgart,Bundesliga,21,2003,0.6,2,1,1,0,1,1,3,33.3,2,2,1,1,0,2,1,0
Tom Krauß,GER,MF,Bochum,Bundesliga,23,2001,12,35,18,20,13,2,19,38,50,19,26,2,24,11,46,19,1
Ladislav Krejčí,CZE,DF,Girona,La Liga,25,1999,27.1,23,16,19,4,0,14,26,53.8,12,24,19,5,34,57,93,5
Rasmus Kristensen,DEN,DF,Eint Frankfurt,Bundesliga,27,1997,27.9,59,33,37,17,5,40,67,59.7,27,50,13,37,20,79,97,1
Thomas Kristensen,DEN,DF,Udinese,Serie A,22,2002,19.5,31,21,16,11,4,20,32,62.5,12,18,13,5,21,52,80,2
Nikola Krstović,MNE,FW,Lecce,Serie A,24,2000,34,18,9,4,7,7,7,16,43.8,9,12,7,5,7,25,24,0
Lukas Kübler,GER,DF,Freiburg,Bundesliga,31,1992,20.5,40,21,17,20,3,27,48,56.3,21,32,13,19,53,93,61,3
Takefusa Kubo,JPN,"MF,FW",Real Sociedad,La Liga,23,2001,26.4,31,20,11,11,9,16,40,40,24,38,1,37,17,48,13,1
Mohammed Kudus,GHA,"FW,MF",West Ham,Premier League,23,2000,28.8,38,23,9,18,11,10,27,37,17,24,1,23,4,42,8,2
Dejan Kulusevski,SWE,"MF,FW",Tottenham,Premier League,24,2000,26.5,45,23,17,13,15,19,51,37.3,32,34,5,29,13,58,10,1
Sael Kumbedi,FRA,DF,Lyon,Ligue 1,19,2005,10.6,28,14,11,13,4,14,20,70,6,11,3,8,8,36,32,1
Marash Kumbulla,ALB,DF,Espanyol,La Liga,24,2000,33,51,26,35,14,2,24,41,58.5,17,48,35,13,34,85,224,2
Jonah Kusi-Asare,SWE,FW,Bayern Munich,Bundesliga,17,2007,0,1,0,0,0,1,0,0,,0,0,0,0,0,1,0,0
Daler Kuzyaev,RUS,MF,Le Havre,Ligue 1,31,1993,6.3,13,8,7,4,2,2,9,22.2,7,7,4,3,9,22,8,0
Khvicha Kvaratskhelia,GEO,"FW,MF",Napoli,Serie A,23,2001,13.1,15,9,4,10,1,4,15,26.7,11,13,0,13,4,19,7,0
Khvicha Kvaratskhelia,GEO,FW,Paris S-G,Ligue 1,23,2001,10.2,19,13,4,12,3,13,23,56.5,10,7,0,7,2,21,4,0
Moritz-Broni Kwarteng,GHA,"MF,FW",Bochum,Bundesliga,26,1998,1.9,4,3,1,1,2,1,2,50,1,0,0,0,0,4,1,0
Giorgos Kyriakopoulos,GRE,DF,Monza,Serie A,28,1996,31.6,43,26,20,18,5,30,61,49.2,31,28,10,18,23,66,79,0
Luca de la Torre,USA,MF,Celta Vigo,La Liga,26,1998,0,0,0,0,0,0,0,0,,0,0,0,0,0,0,0,0
Rémy Labeau Lascary,GLP,"FW,MF",Lens,Ligue 1,21,2003,7.1,16,10,7,6,3,5,11,45.5,6,5,0,5,1,17,7,0
Gaëtan Laborde,FRA,FW,Nice,Ligue 1,30,1994,20.3,19,13,9,8,2,9,22,40.9,13,16,4,12,6,25,20,0
Nediljko Labrović,CRO,GK,Augsburg,Bundesliga,24,1999,15,0,0,0,0,0,0,0,,0,0,0,0,0,0,12,1
Alexandre Lacazette,FRA,FW,Lyon,Ligue 1,33,1991,22.8,13,6,3,7,3,5,16,31.3,11,13,3,10,8,21,7,0
Younes Lachaab,FRA,"MF,FW",Lille,Ligue 1,19,2005,0.1,1,1,0,0,1,1,1,100,0,0,0,0,1,2,0,0
Maxence Lacroix,FRA,DF,Crystal Palace,Premier League,24,2000,34.6,68,41,52,15,1,32,47,68.1,15,48,22,26,54,122,207,2
Alban Lafont,FRA,GK,Nantes,Ligue 1,25,1999,12,1,1,1,0,0,1,1,100,0,2,0,2,0,1,8,1
Yoel Lago,ESP,DF,Celta Vigo,La Liga,20,2004,6.5,12,8,8,3,1,7,9,77.8,2,5,4,1,4,16,30,0
Konrad Laimer,AUT,DF,Bayern Munich,Bundesliga,27,1997,18.9,49,27,19,22,8,23,48,47.9,25,24,1,23,8,57,24,1
Stefan Lainer,AUT,DF,Gladbach,Bundesliga,31,1992,8.4,22,13,16,5,1,12,14,85.7,2,12,6,6,12,34,30,0
Kenny Lala,MAD,DF,Brest,Ligue 1,32,1991,29.8,66,42,36,23,7,38,57,66.7,19,25,9,16,25,91,75,2
Adam Lallana,ENG,MF,Southampton,Premier League,36,1988,4,8,5,4,4,0,2,12,16.7,10,4,1,3,5,13,5,0
Mathis Lambourde,FRA,"FW,MF",Hellas Verona,Serie A,18,2006,1,3,1,2,1,0,1,3,33.3,2,3,0,3,0,3,1,0
Mohamed Lamine Bayo,GUI,FW,Lille,Ligue 1,26,1998,3.4,1,1,0,0,1,1,1,100,0,0,0,0,0,1,4,0
Tariq Lamptey,GHA,DF,Brighton,Premier League,23,2000,9.6,17,11,8,9,0,9,25,36,16,15,7,8,7,24,23,1
Will Lankshear,ENG,"FW,MF",Tottenham,Premier League,19,2005,0.1,0,0,0,0,0,0,0,,0,0,0,0,0,0,0,0
Gianluca Lapadula,PER,"FW,MF",Cagliari,Serie A,34,1990,3.4,2,0,1,0,1,0,1,0,1,0,0,0,0,2,1,0
Cyle Larin,CAN,FW,Mallorca,La Liga,29,1995,19.6,12,6,1,6,5,3,9,33.3,6,12,3,9,1,13,16,0
Gautier Larsonneur,FRA,GK,Saint-Étienne,Ligue 1,27,1997,34,1,0,1,0,0,0,2,0,2,1,0,1,0,1,25,1
Hugo Larsson,SWE,MF,Eint Frankfurt,Bundesliga,20,2004,26.6,47,27,17,25,5,21,42,50,21,42,11,31,30,77,35,1
Juanmi Latasa,ESP,FW,Valladolid,La Liga,23,2001,15.5,4,2,1,1,2,2,6,33.3,4,4,1,3,0,4,11,1
Toni Lato,ESP,DF,Mallorca,La Liga,26,1997,6.9,17,11,6,5,6,7,11,63.6,4,10,4,6,6,23,33,0
Roméo Lavia,BEL,MF,Chelsea,Premier League,20,2004,8.9,22,13,5,13,4,10,21,47.6,11,6,0,6,16,38,10,1
Valentino Lazaro,AUT,"DF,FW",Torino,Serie A,28,1996,25.6,26,12,10,12,4,15,30,50,15,28,5,23,11,37,38,1
Darko Lazović,SRB,"DF,MF",Hellas Verona,Serie A,33,1990,16.2,21,10,5,14,2,11,28,39.3,17,19,3,16,11,32,39,0
Manuel Lazzari,ITA,DF,Lazio,Serie A,30,1993,15.6,26,16,13,11,2,14,24,58.3,10,9,5,4,10,36,19,0
Julien Le Cardinal,FRA,DF,Brest,Ligue 1,26,1997,15.3,27,15,16,8,3,11,16,68.8,5,18,14,4,33,60,75,0
Jérémy Le Douaron,FRA,FW,Brest,Ligue 1,26,1998,1.1,1,0,0,0,1,0,1,0,1,1,0,1,0,1,0,0
Enzo Le Fée,FRA,MF,Roma,Serie A,24,2000,3.5,7,4,5,2,0,2,6,33.3,4,9,3,6,5,12,2,0
Robin Le Normand,ESP,DF,Atlético Madrid,La Liga,27,1996,23.9,27,18,23,4,0,12,20,60,8,20,9,11,10,37,120,1
Nicola Leali,ITA,GK,Genoa,Serie A,31,1993,29,0,0,0,0,0,0,0,,0,0,0,0,0,0,14,1
Rafael Leão,POR,FW,Milan,Serie A,25,1999,25.8,16,10,4,8,4,11,29,37.9,18,15,1,14,6,22,4,0
Benjamin Lecomte,FRA,GK,Montpellier,Ligue 1,33,1991,30,0,0,0,0,0,0,0,,0,0,0,0,0,0,18,2
Pierre Lees-Melou,FRA,MF,Brest,Ligue 1,31,1993,17,48,33,20,19,9,25,54,46.3,29,19,3,16,12,60,23,0
Jordan Lefort,FRA,DF,Angers,Ligue 1,30,1993,34,52,30,42,9,1,30,44,68.2,14,56,37,19,32,84,206,3
Diogo Leite,POR,DF,Union Berlin,Bundesliga,25,1999,28.3,64,32,43,17,4,33,50,66,17,61,25,36,57,121,162,1
Maxim Leitsch,GER,DF,Mainz 05,Bundesliga,26,1998,7.5,12,4,6,4,2,7,9,77.8,2,12,4,8,10,22,42,1
Florian Lejeune,FRA,DF,Rayo Vallecano,La Liga,33,1991,36.9,46,28,30,14,2,23,43,53.5,20,38,32,6,41,87,181,1
Stefan Lekovic,SRB,DF,Monza,Serie A,20,2004,4.1,9,4,6,2,1,5,13,38.5,8,4,4,0,7,16,5,0
Iñigo Lekue,ESP,DF,Athletic Club,La Liga,31,1993,8.6,15,12,12,3,0,9,17,52.9,8,7,2,5,9,24,29,2
Nunzio Lella,ITA,MF,Venezia,Serie A,24,2000,0.1,0,0,0,0,0,0,0,,0,0,0,0,0,0,0,0
Thomas Lemar,FRA,MF,Atlético Madrid,La Liga,28,1995,0.9,2,1,1,1,0,2,4,50,2,0,0,0,0,2,1,0
Félix Lemaréchal,FRA,"MF,FW",Strasbourg,Ligue 1,20,2003,19.8,35,24,13,17,5,14,29,48.3,15,35,4,31,14,49,19,0
Mario Lemina,GAB,"MF,DF",Wolves,Premier League,30,1993,15.2,51,31,27,19,5,20,29,69,9,12,7,5,27,78,50,3
Clément Lenglet,FRA,DF,Atlético Madrid,La Liga,29,1995,21.9,27,17,19,8,0,11,15,73.3,4,24,18,6,22,49,104,1
Bernd Leno,GER,GK,Fulham,Premier League,32,1992,38,2,2,2,0,0,2,2,100,0,1,0,1,0,2,11,5
Donovan Léon,GUF,GK,Auxerre,Ligue 1,31,1992,32,0,0,0,0,0,0,3,0,3,2,0,2,0,0,26,1
Giovanni Leoni,ITA,DF,Parma,Serie A,17,2006,13.3,14,6,10,4,0,5,10,50,5,20,11,9,15,29,63,1
Esteban Lepaul,FRA,FW,Angers,Ligue 1,24,2000,18.1,11,6,2,6,3,4,16,25,12,15,2,13,4,15,10,0
Johann Lepenant,FRA,MF,Nantes,Ligue 1,21,2002,22.8,68,33,30,27,11,32,71,45.1,39,35,3,32,18,86,25,0
Jefferson Lerma,COL,"MF,DF",Crystal Palace,Premier League,29,1994,25.3,35,17,15,16,4,20,37,54.1,17,38,18,20,42,77,80,1
Louis Leroux,FRA,"MF,DF",Nantes,Ligue 1,18,2006,9.1,25,18,10,12,3,16,22,72.7,6,22,2,20,8,33,19,1
Robert Lewandowski,POL,FW,Barcelona,La Liga,35,1988,29.6,10,5,1,5,4,5,11,45.5,6,14,2,12,3,13,26,0
Jamie Leweling,GER,"MF,FW",Stuttgart,Bundesliga,23,2001,18.5,16,6,6,3,7,11,25,44,14,22,1,21,11,27,17,1
Rico Lewis,ENG,"DF,MF",Manchester City,Premier League,19,2004,21,30,19,13,12,5,13,21,61.9,8,28,7,21,13,43,45,1
Keane Lewis-Potter,ENG,"DF,FW",Brentford,Premier League,23,2001,34.4,49,27,26,16,7,31,50,62,19,28,10,18,21,70,76,3
Myles Lewis-Skelly,ENG,DF,Arsenal,Premier League,17,2006,15.2,22,14,10,9,3,10,11,90.9,1,4,1,3,7,29,27,0
Ben Lhassine Kone,CIV,MF,Como,Serie A,24,2000,0.6,2,2,1,0,1,2,3,66.7,1,0,0,0,1,3,1,0
Mattia Liberali,ITA,MF,Milan,Serie A,17,2007,0.7,2,1,0,1,1,2,2,100,0,0,0,0,0,2,0,0
Philipp Lienhart,AUT,DF,Freiburg,Bundesliga,28,1996,30.8,22,13,12,10,0,15,31,48.4,16,31,20,11,36,58,124,3
Matthijs de Ligt,NED,DF,Manchester Utd,Premier League,24,1999,23.6,30,22,17,12,1,23,32,71.9,9,29,21,8,33,63,96,0
Pedro Lima,BRA,DF,Wolves,Premier League,18,2006,0.8,1,0,0,0,1,1,3,33.3,2,0,0,0,2,3,5,0
Victor Lindelöf,SWE,DF,Manchester Utd,Premier League,30,1994,7.8,7,2,5,1,1,3,4,75,1,6,4,2,8,15,36,2
Jesper Lindstrøm,DEN,FW,Everton,Premier League,24,2000,13.8,45,25,24,19,2,19,55,34.5,36,15,3,12,12,57,17,0
Karol Linetty,POL,MF,Torino,Serie A,29,1995,17.1,39,23,17,19,3,20,41,48.8,21,14,5,9,12,51,31,1
Samuel Lino,BRA,"MF,DF",Atlético Madrid,La Liga,24,1999,17.2,33,17,25,4,4,22,52,42.3,30,23,4,19,8,41,13,0
Pol Lirola,ESP,DF,Marseille,Ligue 1,26,1997,7.6,13,9,5,8,0,5,13,38.5,8,7,2,5,4,17,12,0
Dailon Livramento,CPV,"FW,MF",Hellas Verona,Serie A,23,2001,10.4,15,11,2,7,6,7,13,53.8,6,10,2,8,3,18,9,0
Valentino Livramento,ENG,DF,Newcastle Utd,Premier League,21,2002,31.6,54,36,35,15,4,32,59,54.2,27,37,11,26,23,77,108,1
Marin Ljubicic,CRO,"FW,MF",Union Berlin,Bundesliga,22,2002,3.1,2,1,0,2,0,1,3,33.3,2,2,0,2,0,2,7,0
Javier Llabrés,ESP,FW,Mallorca,La Liga,21,2002,0.6,0,0,0,0,0,0,0,,0,1,0,1,0,0,0,0
Diego Llorente,ESP,DF,Betis,La Liga,30,1993,28,36,20,23,12,1,25,38,65.8,13,29,20,9,43,79,154,1
Marcos Llorente,ESP,"DF,MF",Atlético Madrid,La Liga,29,1995,27.9,69,52,38,27,4,36,55,65.5,19,32,7,25,27,96,51,1
Gautier Lloris,FRA,DF,Le Havre,Ligue 1,29,1995,30.8,68,43,52,16,0,38,53,71.7,15,33,21,12,34,102,192,0
Giovani Lo Celso,ARG,"MF,FW",Betis,La Liga,28,1996,16.2,34,22,8,17,9,17,25,68,8,14,2,12,5,39,3,1
Stanislav Lobotka,SVK,MF,Napoli,Serie A,29,1994,29.3,47,30,16,21,10,19,31,61.3,12,29,11,18,21,68,57,1
Manuel Locatelli,ITA,MF,Juventus,Serie A,26,1998,31.4,72,49,29,35,8,32,56,57.1,24,58,20,38,23,95,77,0
Bradley Locko,FRA,DF,Brest,Ligue 1,22,2002,1.1,2,2,1,1,0,1,1,100,0,3,2,1,1,3,3,0
Ruben Loftus-Cheek,ENG,MF,Milan,Serie A,28,1996,11.5,19,8,6,9,4,6,12,50,6,3,0,3,3,22,20,0
Elysée Logbo,FRA,FW,Le Havre,Ligue 1,20,2004,0.3,0,0,0,0,0,0,0,,0,0,0,0,0,0,0,0
Enzo Loiodice,FRA,MF,Las Palmas,La Liga,23,2000,7.6,17,7,8,9,0,3,10,30,7,4,1,3,10,27,7,2
Sean Longstaff,ENG,MF,Newcastle Utd,Premier League,26,1997,8.9,27,16,10,9,8,18,27,66.7,9,17,5,12,7,34,8,0
Ademola Lookman,NGA,"MF,FW",Atalanta,Serie A,26,1997,25,32,15,9,15,8,11,19,57.9,8,19,0,19,3,35,5,1
Anthony Lopes,POR,GK,Nantes,Ligue 1,33,1990,17.4,1,0,1,0,0,1,1,100,0,0,0,0,1,2,7,1
David López,ESP,DF,Mallorca,La Liga,21,2003,1.9,3,2,3,0,0,2,2,100,0,2,2,0,1,4,10,0
David López,ESP,DF,Girona,La Liga,34,1989,27,32,24,22,7,3,18,31,58.1,13,22,12,10,14,46,111,2
Diego López,ESP,"MF,FW",Valencia,La Liga,22,2002,30.4,31,18,11,16,4,16,47,34,31,30,0,30,16,47,15,0
Fer López,,"FW,MF",Celta Vigo,La Liga,,,7.5,9,5,1,6,2,2,13,15.4,11,10,0,10,2,11,7,0
Fermin López,ESP,"MF,FW",Barcelona,La Liga,21,2003,13.9,19,15,3,9,7,8,32,25,24,11,0,11,5,24,3,0
Javi López,ESP,DF,Real Sociedad,La Liga,22,2002,21.5,40,23,23,12,5,23,37,62.2,14,21,7,14,11,51,59,2
Pau López,ESP,GK,Girona,La Liga,29,1994,0.5,0,0,0,0,0,0,0,,0,0,0,0,0,0,1,0
Roberto López,ESP,MF,Leganés,La Liga,24,2000,4.4,8,6,4,4,0,5,15,33.3,10,5,0,5,1,9,7,2
Unai López,ESP,MF,Rayo Vallecano,La Liga,28,1995,19,31,21,14,12,5,17,36,47.2,19,18,6,12,21,52,20,0
Iker Losada,ESP,"FW,MF",Celta Vigo,La Liga,22,2001,4,3,3,0,1,2,1,5,20,4,4,1,3,1,4,8,0
Iker Losada,ESP,"MF,FW",Betis,La Liga,22,2001,3.7,10,7,2,4,4,5,10,50,5,2,0,2,3,13,2,0
Anthony Losilla,FRA,MF,Bochum,Bundesliga,38,1986,12.6,30,16,15,12,3,17,33,51.5,16,22,7,15,18,48,27,1
Jordan Lotomba,SUI,"MF,DF",Nice,Ligue 1,25,1998,0.4,0,0,0,0,0,0,0,,0,0,0,0,0,0,1,0
Tom Louchet,FRA,"DF,MF",Nice,Ligue 1,21,2003,8.6,27,17,17,5,5,17,23,73.9,6,12,4,8,18,45,20,0
Sandi Lovrić,SVN,MF,Udinese,Serie A,26,1998,25.6,46,29,25,17,4,22,44,50,22,33,5,28,22,68,27,1
Pol Lozano,ESP,MF,Espanyol,La Liga,24,1999,21.6,53,34,23,25,5,25,58,43.1,33,32,6,26,22,75,31,0
Lorenzo Lucca,ITA,FW,Udinese,Serie A,23,2000,26.1,10,6,3,2,5,5,11,45.5,6,18,1,17,7,17,27,0
Jhon Lucumí,COL,DF,Bologna,Serie A,26,1998,29,53,30,23,29,1,29,41,70.7,12,32,14,18,26,79,88,7
Yannik Lührs,GER,DF,Dortmund,Bundesliga,20,2003,1.4,1,1,1,0,0,0,0,,0,0,0,0,2,3,4,0
José Luis Gayà,ESP,DF,Valencia,La Liga,29,1995,20,57,40,39,15,3,40,58,69,18,16,2,14,25,82,61,0
José Luis Palomino,ARG,DF,Cagliari,Serie A,34,1990,12,27,15,16,9,2,15,21,71.4,6,21,11,10,22,49,46,0
Douglas Luiz,BRA,MF,Juventus,Serie A,26,1998,5.9,13,8,7,5,1,6,9,66.7,3,5,2,3,4,17,5,0
Romelu Lukaku,BEL,FW,Napoli,Serie A,31,1993,31.6,4,2,0,2,2,1,4,25,3,7,2,5,1,5,17,0
Castello Lukeba,FRA,DF,RB Leipzig,Bundesliga,21,2002,17.5,31,17,15,12,4,17,24,70.8,7,29,12,17,17,48,74,0
Dodi Lukebakio,BEL,FW,Sevilla,La Liga,26,1997,34.4,22,14,8,8,6,15,27,55.6,12,18,1,17,11,33,17,2
Saša Lukić,SRB,MF,Fulham,Premier League,27,1996,26,68,39,22,40,6,23,55,41.8,32,20,7,13,28,96,35,1
Milos Lukovic,SRB,"FW,MF",Strasbourg,Ligue 1,18,2005,0.1,0,0,0,0,0,0,0,,0,0,0,0,0,0,0,0
Joe Lumley,ENG,GK,Southampton,Premier League,29,1995,3,0,0,0,0,0,0,0,,0,0,0,0,0,0,3,3
Daniel Luna,COL,MF,Mallorca,La Liga,21,2003,0.2,0,0,0,0,0,0,0,,0,1,0,1,0,0,0,0
Andriy Lunin,UKR,GK,Real Madrid,La Liga,25,1999,7,1,0,1,0,0,0,0,,0,0,0,0,0,1,3,0
Massimo Luongo,AUS,MF,Ipswich Town,Premier League,31,1992,2.2,9,6,6,2,1,5,8,62.5,3,4,2,2,2,11,2,0
Sebastiano Luperto,ITA,DF,Cagliari,Serie A,27,1996,36,48,27,31,16,1,18,28,64.3,10,30,15,15,33,81,161,1
Zito Luvumbo,ANG,"FW,MF",Cagliari,Serie A,22,2002,17.8,10,6,4,3,3,6,19,31.6,13,5,0,5,4,14,4,0
Charalambos Lykogiannis,GRE,DF,Bologna,Serie A,30,1993,11.6,23,14,14,8,1,10,20,50,10,10,5,5,11,34,41,1
Senne Lynen,BEL,MF,Werder Bremen,Bundesliga,25,1999,30.4,72,39,36,30,6,39,69,56.5,30,56,13,43,65,137,75,5
Mathias Løvik,NOR,"DF,FW",Parma,Serie A,20,2003,1,1,0,0,1,0,1,3,33.3,2,1,1,0,2,3,3,0
Othmane Maamma,MAR,"FW,MF",Montpellier,Ligue 1,18,2005,4,3,1,2,1,0,1,4,25,3,4,0,4,1,4,2,1
Ian Maatsen,NED,DF,Aston Villa,Premier League,22,2002,12.7,29,17,17,9,3,17,24,70.8,7,13,0,13,15,44,39,3
Alexis Mac Allister,ARG,MF,Liverpool,Premier League,25,1998,28.9,95,58,28,51,16,55,104,52.9,49,61,6,55,22,117,29,1
Deiver Machado,COL,"DF,MF",Lens,Ligue 1,30,1993,20.1,36,26,14,14,8,17,30,56.7,13,20,4,16,16,52,34,2
Lanroy Machine,FRA,FW,Angers,Ligue 1,18,2005,0.1,0,0,0,0,0,0,0,,0,0,0,0,0,0,0,0
Shuto Machino,JPN,"FW,MF",Holstein Kiel,Bundesliga,24,1999,21.7,8,5,4,3,1,6,16,37.5,10,12,3,9,7,15,28,1
Darwin Machís,VEN,"MF,FW",Valladolid,La Liga,31,1993,7.1,5,4,3,2,0,3,9,33.3,6,3,0,3,5,10,13,0
Yvann Macon,FRA,DF,Saint-Étienne,Ligue 1,25,1998,8.8,19,11,9,7,3,10,21,47.6,11,14,4,10,2,21,10,1
James Maddison,ENG,MF,Tottenham,Premier League,27,1996,20.1,31,19,8,16,7,9,29,31,20,15,4,11,12,43,19,1
Eros Maddy,NED,DF,Auxerre,Ligue 1,23,2001,0.2,0,0,0,0,0,0,0,,0,0,0,0,0,0,0,0
Noni Madueke,ENG,FW,Chelsea,Premier League,22,2002,22.6,25,18,8,12,5,14,38,36.8,24,17,0,17,10,35,11,0
Pablo Maffeo,ESP,DF,Mallorca,La Liga,27,1997,26.3,60,40,43,14,3,34,46,73.9,12,32,11,21,25,85,103,1
Gabriel Magalhães,BRA,DF,Arsenal,Premier League,26,1997,26.3,25,15,12,8,5,12,16,75,4,42,29,13,16,41,93,2
Soungoutou Magassa,FRA,MF,Monaco,Ligue 1,20,2003,11.4,47,25,14,27,6,25,46,54.3,21,16,3,13,21,68,19,1
Edmond-Paris Maghoma,ENG,"MF,FW",Brentford,Premier League,23,2001,1.3,2,1,0,2,0,1,3,33.3,2,2,2,0,1,3,2,0
Giangiacomo Magnani,ITA,DF,Hellas Verona,Serie A,28,1995,11.8,20,15,14,6,0,7,7,100,0,16,9,7,17,37,73,1
Hugo Magnetti,FRA,MF,Brest,Ligue 1,26,1998,25.8,52,32,21,27,4,23,51,45.1,28,20,3,17,18,70,37,0
Frank Magri,CMR,"FW,MF",Toulouse,Ligue 1,24,1999,16.8,8,2,1,6,1,3,8,37.5,5,16,2,14,4,12,11,0
Harry Maguire,ENG,DF,Manchester Utd,Premier League,31,1993,19.5,30,15,23,6,1,17,23,73.9,6,15,12,3,40,70,78,1
Jon Magunazelaia,ESP,MF,Real Sociedad,La Liga,23,2001,0.1,1,1,1,0,0,0,0,,0,0,0,0,0,1,0,0
Arne Maier,GER,MF,Augsburg,Bundesliga,25,1999,10.4,13,7,4,8,1,7,13,53.8,6,15,1,14,6,19,14,1
Mike Maignan,FRA,GK,Milan,Serie A,29,1995,36.6,0,0,0,0,0,0,1,0,1,1,0,1,0,0,19,3
Patrick Mainka,GER,DF,Heidenheim,Bundesliga,29,1994,34,58,30,36,20,2,35,55,63.6,20,61,36,25,68,126,206,0
Kobbie Mainoo,ENG,MF,Manchester Utd,Premier League,19,2005,18.3,46,29,18,14,14,24,40,60,16,16,2,14,19,65,14,1
Ainsley Maitland-Niles,ENG,DF,Lyon,Ligue 1,26,1997,22.1,71,44,30,26,15,48,76,63.2,28,28,4,24,25,96,61,6
Radosław Majecki,POL,GK,Monaco,Ligue 1,24,1999,15,0,0,0,0,0,0,2,0,2,0,0,0,0,0,8,1
Lovro Majer,CRO,MF,Wolfsburg,Bundesliga,26,1998,3.4,2,1,0,1,1,1,5,20,4,5,1,4,1,3,2,1
Hamidou Makalou,MLI,"FW,MF",Brest,Ligue 1,18,2006,0.4,0,0,0,0,0,0,0,,0,0,0,0,0,0,0,0
Jordy Makengo,FRA,DF,Freiburg,Bundesliga,22,2001,8.3,16,9,10,5,1,10,16,62.5,6,8,3,5,7,23,29,0
Antoine Makoumbou,CGO,MF,Cagliari,Serie A,26,1998,23.9,42,23,28,11,3,19,25,76,6,26,5,21,17,59,28,0
Nikola Maksimović,SRB,DF,Montpellier,Ligue 1,32,1991,6.5,9,5,6,3,0,6,7,85.7,1,5,4,1,6,15,30,1
Tyrell Malacia,NED,DF,Manchester Utd,Premier League,24,1999,1.1,2,1,2,0,0,1,2,50,1,0,0,0,1,3,1,1
Jarzinho Malanga,GER,DF,Stuttgart,Bundesliga,18,2006,0,0,0,0,0,0,0,0,,0,0,0,0,0,0,0,0
Julián Malatini,ARG,DF,Werder Bremen,Bundesliga,23,2001,5,11,9,5,5,1,5,11,45.5,6,8,3,5,7,18,17,0
Daniel Maldini,ITA,"MF,FW",Monza,Serie A,22,2001,14.5,14,6,5,9,0,6,13,46.2,7,8,2,6,4,18,12,2
Daniel Maldini,ITA,"FW,MF",Atalanta,Serie A,22,2001,2.9,2,2,0,1,1,1,2,50,1,1,0,1,2,4,3,0
Youssef Maleh,MAR,MF,Empoli,Serie A,25,1998,16.8,45,23,17,23,5,17,34,50,17,25,6,19,16,61,25,0
Donyell Malen,NED,FW,Aston Villa,Premier League,25,1999,3.4,7,4,3,3,1,1,4,25,3,2,0,2,0,7,1,0
Donyell Malen,NED,"FW,MF",Dortmund,Bundesliga,25,1999,6.8,0,0,0,0,0,0,2,0,2,2,0,2,3,3,6,0
Ruslan Malinovskyi,UKR,"MF,FW",Genoa,Serie A,31,1993,4.3,12,8,4,7,1,3,6,50,3,2,0,2,1,13,4,0
Lennard Maloney,USA,MF,Heidenheim,Bundesliga,24,1999,8.4,20,11,12,7,1,14,23,60.9,9,9,2,7,14,34,38,0
Lennard Maloney,USA,MF,Mainz 05,Bundesliga,24,1999,0.3,2,1,0,1,1,1,1,100,0,2,0,2,0,2,3,0
Aaron Malouda,FRA,FW,Lille,Ligue 1,18,2005,0,0,0,0,0,0,0,0,,0,0,0,0,0,0,0,0
Giorgi Mamardashvili,GEO,GK,Valencia,La Liga,23,2000,34,2,2,2,0,0,2,3,66.7,1,0,0,0,1,3,16,3
Dennis Man,ROU,"FW,MF",Parma,Serie A,25,1998,22.2,13,6,7,3,3,6,24,25,18,15,3,12,8,21,11,0
Hianga Mananga Mbock,FRA,MF,Brest,Ligue 1,24,1999,0.2,0,0,0,0,0,0,0,,0,0,0,0,1,1,0,0
Gianluca Mancini,ITA,DF,Roma,Serie A,28,1996,34.9,42,26,22,18,2,20,34,58.8,14,22,16,6,35,77,103,0
Steve Mandanda,FRA,GK,Rennes,Ligue 1,39,1985,16.5,0,0,0,0,0,0,1,0,1,0,0,0,0,0,6,2
Christos Mandas,GRE,GK,Lazio,Serie A,22,2001,9,0,0,0,0,0,0,0,,0,0,0,0,0,0,4,0
Reinildo Mandava,MOZ,DF,Atlético Madrid,La Liga,30,1994,10.5,18,11,10,7,1,10,18,55.6,8,11,5,6,16,34,35,0
Aïssa Mandi,ALG,DF,Lille,Ligue 1,32,1991,19.3,31,17,12,15,4,16,22,72.7,6,23,11,12,15,46,54,0
Rolando Mandragora,ITA,MF,Fiorentina,Serie A,27,1997,20.6,23,13,9,12,2,14,31,45.2,17,22,7,15,15,38,54,1
Mateus Mane,,MF,Wolves,Premier League,,,0,0,0,0,0,0,0,0,,0,1,0,1,0,0,0,0
Orel Mangala,BEL,MF,Everton,Premier League,26,1998,14,16,8,3,11,2,5,8,62.5,3,8,3,5,21,37,24,1
Orel Mangala,BEL,MF,Lyon,Ligue 1,26,1998,0.7,1,0,0,0,1,0,1,0,1,2,0,2,0,1,1,0
Ryan Manning,IRL,"DF,MF",Southampton,Premier League,28,1996,16.2,28,17,16,10,2,14,26,53.8,12,20,11,9,17,45,47,0
Javier Manquillo,ESP,DF,Celta Vigo,La Liga,30,1994,5.7,7,5,4,3,0,2,10,20,8,5,3,2,7,14,14,0
Johan Manzambi,SUI,"FW,MF",Freiburg,Bundesliga,18,2005,3.7,8,2,1,3,4,1,4,25,3,6,0,6,4,12,7,0
Alberto Manzoni,ITA,MF,Atalanta,Serie A,19,2005,0.1,0,0,0,0,0,0,0,,0,0,0,0,0,0,0,0
Sekou Mara,FRA,"FW,MF",Strasbourg,Ligue 1,22,2002,8.5,9,6,0,5,4,3,9,33.3,6,11,0,11,3,12,3,0
Alessandro Marcandalli,ITA,DF,Genoa,Serie A,21,2002,0.5,1,0,1,0,0,0,0,,0,0,0,0,0,1,2,0
Alessandro Marcandalli,ITA,DF,Venezia,Serie A,21,2002,3.9,8,6,6,2,0,3,6,50,3,6,3,3,2,10,26,0
Marcão,BRA,DF,Sevilla,La Liga,28,1996,6.1,10,7,6,4,0,3,5,60,2,9,6,3,7,17,29,1
Solly March,ENG,"FW,MF",Brighton,Premier League,30,1994,1.9,6,3,2,2,2,5,8,62.5,3,3,0,3,2,8,2,1
Filip Marchwiński,POL,MF,Lecce,Serie A,22,2002,0.2,0,0,0,0,0,0,0,,0,0,0,0,0,0,0,0
Óscar de Marcos,ESP,DF,Athletic Club,La Liga,35,1989,17.4,32,15,15,13,4,21,37,56.8,16,17,1,16,16,48,35,0
Alberto Marí,ESP,FW,Valencia,La Liga,23,2001,0.1,0,0,0,0,0,0,0,,0,0,0,0,0,0,0,0
Pablo Marí,ESP,DF,Monza,Serie A,30,1993,18.1,26,15,14,12,0,11,21,52.4,10,24,21,3,37,63,85,2
Pablo Marí,ESP,DF,Fiorentina,Serie A,30,1993,12.2,14,9,11,3,0,6,11,54.5,5,19,14,5,25,39,94,0
José María Giménez,URU,DF,Atlético Madrid,La Liga,29,1995,22.2,26,16,18,8,0,17,28,60.7,11,29,19,10,27,53,115,2
Luca Marianucci,ITA,DF,Empoli,Serie A,20,2004,11.9,28,12,17,11,0,11,19,57.9,8,16,8,8,19,47,63,1
Mirko Marić,CRO,"FW,MF",Monza,Serie A,29,1995,1.2,1,0,1,0,0,1,2,50,1,1,1,0,1,2,1,0
Mirko Marić,CRO,FW,Venezia,Serie A,29,1995,4,6,3,5,1,0,2,5,40,3,3,1,2,1,7,10,0
Arkaitz Mariezkurrena,ESP,"FW,MF",Real Sociedad,La Liga,19,2005,2.7,1,0,1,0,0,0,4,0,4,4,1,3,1,2,4,0
Rafa Marín,ESP,DF,Napoli,Serie A,22,2002,1.6,1,0,1,0,0,1,2,50,1,1,1,0,1,2,4,0
Pablo Marín,ESP,MF,Real Sociedad,La Liga,21,2003,13.8,25,17,6,13,6,10,19,52.6,9,12,3,9,5,30,14,0
Răzvan Marin,ROU,MF,Cagliari,Serie A,28,1996,15.6,22,13,8,11,3,13,25,52,12,7,0,7,2,24,20,2
Guillermo Maripán,CHI,DF,Torino,Serie A,30,1994,26,40,23,25,14,1,21,33,63.6,12,27,13,14,41,81,138,1
Mika Mármol,ESP,DF,Las Palmas,La Liga,23,2001,26.7,61,29,35,24,2,34,52,65.4,18,46,14,32,38,99,121,2
Omar Marmoush,EGY,"FW,MF",Manchester City,Premier League,25,1999,13.1,13,8,2,9,2,8,16,50,8,15,1,14,6,19,3,0
Omar Marmoush,EGY,FW,Eint Frankfurt,Bundesliga,25,1999,16.1,12,8,0,3,9,3,7,42.9,4,7,1,6,2,14,2,0
Mario Maroto,ESP,MF,Valladolid,La Liga,20,2003,0.7,0,0,0,0,0,0,2,0,2,0,0,0,2,2,2,0
Marquinhos,BRA,DF,Paris S-G,Ligue 1,30,1994,19.2,30,19,8,16,6,25,33,75.8,8,27,15,12,11,41,64,0
Unai Marrero,ESP,GK,Real Sociedad,La Liga,22,2001,2,0,0,0,0,0,0,0,,0,0,0,0,0,0,1,0
Ange Martial Tia,MLI,"MF,DF",Reims,Ligue 1,17,2006,1.9,4,3,1,2,1,2,6,33.3,4,3,0,3,2,6,4,0
Aarón Martín,ESP,DF,Genoa,Serie A,27,1997,34.3,71,47,41,26,4,33,51,64.7,18,33,11,22,19,90,73,1
Carlos Martín,ESP,"FW,MF",Alavés,La Liga,22,2002,14.8,43,21,18,16,9,13,49,26.5,36,30,1,29,5,48,20,0
Diego Martín,ESP,FW,Las Palmas,La Liga,20,2003,0.4,1,1,0,0,1,1,1,100,0,0,0,0,0,1,1,0
Gerard Martín,ESP,DF,Barcelona,La Liga,22,2002,11.5,22,10,10,7,5,11,16,68.8,5,16,2,14,13,35,27,0
Iván Martín,ESP,MF,Girona,La Liga,25,1999,22.7,32,19,14,14,4,15,34,44.1,19,20,6,14,11,43,15,1
Jon Martin,ESP,DF,Real Sociedad,La Liga,18,2006,10,11,9,7,3,1,6,9,66.7,3,13,9,4,7,18,80,1
Jonas Martin,FRA,MF,Brest,Ligue 1,34,1990,5.5,13,7,10,2,1,6,11,54.5,5,4,1,3,8,21,12,1
Mario Martín,ESP,MF,Valladolid,La Liga,20,2004,19.4,62,32,31,27,4,21,49,42.9,28,32,7,25,21,83,46,7
Gabriel Martinelli,BRA,"FW,MF",Arsenal,Premier League,23,2001,25.4,23,15,9,6,8,7,23,30.4,16,15,0,15,5,28,19,0
Arnau Martinez,ESP,"DF,MF",Girona,La Liga,21,2003,29.2,51,28,30,15,6,32,63,50.8,31,18,6,12,31,82,76,2
Emiliano Martínez,ARG,GK,Aston Villa,Premier League,31,1992,35.5,3,3,3,0,0,2,2,100,0,1,0,1,0,3,17,6
Iñigo Martínez,ESP,DF,Barcelona,La Liga,33,1991,27.7,25,14,20,5,0,16,22,72.7,6,18,7,11,18,43,108,1
Javi Martínez,ESP,MF,Osasuna,La Liga,24,1999,0.1,0,0,0,0,0,0,0,,0,0,0,0,0,0,0,0
Josep Martinez,ESP,GK,Inter,Serie A,26,1998,5,0,0,0,0,0,0,0,,0,0,0,0,0,0,0,0
Lautaro Martínez,ARG,FW,Inter,Serie A,26,1997,27.5,30,16,10,12,8,13,25,52,12,21,3,18,10,40,15,0
Lisandro Martínez,ARG,DF,Manchester Utd,Premier League,26,1998,19.5,40,24,25,12,3,21,36,58.3,15,22,8,14,32,72,57,1
Lucas Martínez Quarta,ARG,DF,Fiorentina,Serie A,28,1996,3.9,12,7,9,3,0,8,13,61.5,5,5,2,3,3,15,25,1
Ramón Martínez,ESP,DF,Sevilla,La Liga,21,2002,2.9,6,3,5,1,0,3,5,60,2,2,1,1,2,8,23,0
Toni Martínez,ESP,FW,Alavés,La Liga,27,1997,11.2,12,7,5,4,3,4,8,50,4,8,2,6,1,13,15,0
Kevin Martins,ITA,"MF,DF",Monza,Serie A,19,2005,2,5,4,3,2,0,3,6,50,3,1,0,1,1,6,4,1
Javi Martón,ESP,"FW,MF",Athletic Club,La Liga,25,1999,0.6,0,0,0,0,0,0,0,,0,0,0,0,0,0,0,0
Adam Marušić,MNE,DF,Lazio,Serie A,31,1992,26,32,20,18,12,2,18,30,60,12,18,8,10,16,48,61,0
Marvin,ESP,"DF,FW",Las Palmas,La Liga,24,2000,11.5,25,13,12,9,4,11,26,42.3,15,17,6,11,15,40,34,0
Omar Mascarell,EQG,MF,Mallorca,La Liga,31,1993,22.1,27,13,13,13,1,14,35,40,21,33,21,12,49,76,59,3
Adam Masina,MAR,DF,Torino,Serie A,30,1994,21.3,33,15,22,10,1,23,40,57.5,17,28,15,13,27,60,95,2
Patrizio Masini,ITA,MF,Genoa,Serie A,23,2001,17.1,54,29,18,26,10,19,40,47.5,21,26,8,18,15,69,37,0
Giorgos Masouras,GRE,"FW,MF",Bochum,Bundesliga,30,1994,11.7,18,10,6,7,5,7,16,43.8,9,9,1,8,4,22,3,1
Erhan Mašović,SRB,DF,Bochum,Bundesliga,25,1998,10.1,14,10,10,4,0,13,28,46.4,15,17,11,6,12,26,55,0
Han-Noah Massengo,FRA,MF,Auxerre,Ligue 1,23,2001,11.6,17,11,5,8,4,8,12,66.7,4,12,4,8,17,34,10,2
Clinton Mata,ANG,DF,Lyon,Ligue 1,31,1992,26.3,41,29,23,14,4,28,36,77.8,8,26,17,9,46,87,72,3
Jaime Mata,ESP,"FW,MF",Las Palmas,La Liga,35,1988,7.3,8,2,2,6,0,3,9,33.3,6,5,1,4,3,11,11,0
Igor Matanovic,CRO,FW,Eint Frankfurt,Bundesliga,21,2003,3.5,2,0,0,2,0,0,1,0,1,3,0,3,1,3,9,0
Pape Matar Sarr,SEN,MF,Tottenham,Premier League,21,2002,21.3,49,36,19,23,7,12,24,50,12,26,10,16,30,79,25,1
Eliot Matazo,BEL,MF,Monaco,Ligue 1,22,2002,0.8,3,2,0,3,0,0,0,,0,0,0,0,1,4,2,0
Jean-Philippe Mateta,FRA,FW,Crystal Palace,Premier League,27,1997,29.4,18,12,5,11,2,3,16,18.8,13,18,4,14,2,20,23,0
Nemanja Matić,SRB,MF,Lyon,Ligue 1,35,1988,22.3,42,29,15,21,6,23,41,56.1,18,21,9,12,18,60,31,1
Rudy Matondo,FRA,MF,Auxerre,Ligue 1,16,2008,0.7,1,1,1,0,0,0,1,0,1,0,0,0,0,1,2,0
Chrislain Matsima,FRA,DF,Augsburg,Bundesliga,22,2002,28.3,31,20,19,11,1,17,26,65.4,9,48,29,19,52,83,163,0
Jean Mattéo Bahoya,FRA,"MF,FW",Eint Frankfurt,Bundesliga,19,2005,10.2,29,18,11,13,5,16,26,61.5,10,14,2,12,4,33,10,1
Alan Matturro,URU,DF,Genoa,Serie A,19,2004,10,11,6,6,5,0,3,14,21.4,11,10,3,7,14,25,38,0
Azor Matusiwa,NED,MF,Rennes,Ligue 1,26,1998,23.1,64,39,32,30,2,32,43,74.4,11,29,10,19,34,98,52,0
Neal Maupay,FRA,FW,Marseille,Ligue 1,27,1996,11.6,9,4,1,6,2,3,6,50,3,5,0,5,2,11,0,0
Maurides,BRA,FW,St. Pauli,Bundesliga,30,1994,0,0,0,0,0,0,0,0,,0,0,0,0,0,0,0,0
Stephy Mavididi,ENG,FW,Leicester City,Premier League,26,1998,17.9,34,19,16,10,8,14,42,33.3,28,26,2,24,11,45,15,0
Konstantinos Mavropanos,GRE,DF,West Ham,Premier League,26,1997,22.7,35,24,24,10,1,16,27,59.3,11,25,18,7,40,75,126,1
Christian Mawissa,FRA,DF,Monaco,Ligue 1,19,2005,16.7,42,29,27,13,2,26,44,59.1,18,25,6,19,26,68,48,1
Keke Maximilian Topp,GER,"FW,MF",Werder Bremen,Bundesliga,20,2004,2.8,3,1,0,2,1,1,2,50,1,0,0,0,1,4,4,0
Borja Mayoral,ESP,FW,Getafe,La Liga,27,1997,12.4,5,4,2,2,1,3,9,33.3,6,4,0,4,2,7,6,0
Senny Mayulu,FRA,MF,Paris S-G,Ligue 1,18,2006,9,25,16,8,14,3,8,14,57.1,6,8,3,5,5,30,12,0
Noussair Mazraoui,MAR,DF,Manchester Utd,Premier League,26,1997,31.5,115,68,58,42,15,59,94,62.8,35,36,9,27,34,149,95,1
Andrea Mazza,ITA,GK,Monza,Serie A,20,2004,0.1,0,0,0,0,0,0,0,,0,0,0,0,0,0,0,0
Luca Mazzitelli,ITA,MF,Como,Serie A,28,1995,3.7,9,6,4,5,0,5,7,71.4,2,5,2,3,3,12,10,0
Pasquale Mazzocchi,ITA,"DF,FW",Napoli,Serie A,29,1995,7.8,15,7,7,5,3,8,15,53.3,7,5,2,3,5,20,25,0
Samuel Mbangula,BEL,FW,Juventus,Serie A,20,2004,7.9,15,10,7,6,2,7,13,53.8,6,7,0,7,3,18,4,0
Ethan Mbappé,FRA,"MF,FW",Lille,Ligue 1,17,2006,2.5,6,2,3,2,1,0,4,0,4,6,0,6,1,7,0,0
Kylian Mbappé,FRA,FW,Real Madrid,La Liga,25,1998,32.3,8,5,1,3,4,1,5,20,4,3,0,3,1,9,1,1
Ibrahim Mbaye,FRA,"FW,MF",Paris S-G,Ligue 1,16,2008,3.8,4,2,1,2,1,3,8,37.5,5,2,0,2,2,6,2,0
Bryan Mbeumo,CMR,FW,Brentford,Premier League,24,1999,37.9,49,31,18,15,16,21,35,60,14,26,3,23,14,63,55,1
James Mcatee,ENG,"MF,FW",Manchester City,Premier League,21,2002,3.9,5,2,0,4,1,1,7,14.3,6,8,0,8,2,7,1,0
Kasey McAteer,IRL,FW,Leicester City,Premier League,22,2001,9.5,23,16,11,9,3,14,29,48.3,15,18,2,16,5,28,15,0
Oliver McBurnie,SCO,FW,Las Palmas,La Liga,28,1996,20.4,15,7,5,8,2,5,12,41.7,7,15,5,10,6,21,24,0
Alex McCarthy,ENG,GK,Southampton,Premier League,34,1989,5,0,0,0,0,0,0,0,,0,0,0,0,0,0,1,4
John McGinn,SCO,"MF,FW",Aston Villa,Premier League,29,1994,24.7,33,24,10,14,9,13,31,41.9,18,22,2,20,14,47,18,3
Scott McKenna,SCO,DF,Las Palmas,La Liga,27,1996,27.4,21,13,16,5,0,9,12,75,3,36,28,8,9,30,163,2
Weston McKennie,USA,"MF,DF",Juventus,Serie A,25,1998,25.7,33,12,18,11,4,13,22,59.1,9,28,8,20,14,47,37,0
Mark McKenzie,USA,DF,Toulouse,Ligue 1,25,1999,27.7,52,31,31,20,1,33,45,73.3,12,31,18,13,22,74,141,1
Dwight McNeil,ENG,"MF,FW",Everton,Premier League,24,1999,15.2,13,8,6,5,2,9,21,42.9,12,7,0,7,6,19,2,1
Scott McTominay,SCO,MF,Manchester Utd,Premier League,27,1996,0.2,0,0,0,0,0,0,1,0,1,0,0,0,0,0,1,0
Scott McTominay,SCO,MF,Napoli,Serie A,27,1996,32.6,43,25,12,27,4,18,36,50,18,22,5,17,24,67,51,0
Jakov Medić,CRO,DF,Bochum,Bundesliga,25,1998,17.8,13,11,9,3,1,8,18,44.4,10,32,21,11,22,35,111,4
Facundo Medina,ARG,DF,Lens,Ligue 1,25,1999,28.3,44,29,22,18,4,24,42,57.1,18,30,10,20,32,76,70,0
Ben Mee,ENG,DF,Brentford,Premier League,34,1989,2,2,2,0,2,0,1,1,100,0,3,3,0,4,6,7,0
Jayden Meghoma,ENG,DF,Brentford,Premier League,18,2006,0.1,0,0,0,0,0,0,0,,0,0,0,0,0,0,0,0
Henrik Meister,DEN,FW,Rennes,Ligue 1,20,2003,0.7,2,0,0,2,0,0,0,,0,4,0,4,1,3,0,0
Bamo Meïté,CIV,DF,Montpellier,Ligue 1,22,2001,4.7,5,3,2,1,2,1,2,50,1,3,3,0,4,9,14,3
Bamo Meïté,CIV,DF,Marseille,Ligue 1,22,2001,0.3,0,0,0,0,0,0,0,,0,0,0,0,0,0,1,0
Mohamed Meité,FRA,FW,Rennes,Ligue 1,16,2007,6,2,0,0,2,0,1,1,100,0,1,0,1,0,2,5,0
Mateo Mejía,ESP,FW,Sevilla,La Liga,21,2003,0.1,0,0,0,0,0,0,0,,0,0,0,0,0,0,0,0
Farid El Melali,ALG,FW,Angers,Ligue 1,27,1997,21,28,16,15,6,7,13,35,37.1,22,19,1,18,16,44,12,1
Filippo Melegoni,ITA,"MF,FW",Genoa,Serie A,25,1999,1,1,1,1,0,0,0,4,0,4,0,0,0,0,1,2,0
Arthur Melo,BRA,MF,Girona,La Liga,27,1996,10.5,25,11,8,12,5,14,27,51.9,13,5,1,4,8,33,12,1
Nuno Mendes,POR,DF,Paris S-G,Ligue 1,22,2002,18.6,30,19,15,12,3,23,39,59,16,25,8,17,18,48,37,2
Brais Méndez,ESP,MF,Real Sociedad,La Liga,27,1997,17,24,13,6,14,4,9,24,37.5,15,14,1,13,7,31,16,1
Antoine Mendy,SEN,DF,Nice,Ligue 1,20,2004,9.2,30,21,16,14,0,19,29,65.5,10,9,5,4,8,38,29,1
Ferland Mendy,FRA,DF,Real Madrid,La Liga,29,1995,11.2,17,14,7,6,4,9,12,75,3,11,4,7,9,26,8,1
Nampalys Mendy,SEN,MF,Lens,Ligue 1,32,1992,6.5,15,8,4,7,4,6,14,42.9,8,8,2,6,9,24,8,0
Nobel Mendy,FRA,DF,Betis,La Liga,19,2004,1.2,0,0,0,0,0,0,0,,0,2,0,2,4,4,10,1
Gideon Mensah,GHA,DF,Auxerre,Ligue 1,26,1998,25.3,68,45,37,21,10,33,66,50,33,27,4,23,50,118,83,0
Alex Meret,ITA,GK,Napoli,Serie A,27,1997,33.4,0,0,0,0,0,0,0,,0,1,0,1,0,0,16,0
Mikel Merino,ESP,"MF,FW",Arsenal,Premier League,28,1996,17.6,46,28,7,26,13,20,36,55.6,16,18,5,13,15,61,26,2
Quentin Merlin,FRA,DF,Marseille,Ligue 1,22,2002,17.7,22,17,12,5,5,9,16,56.3,7,20,4,16,14,36,17,1
Víctor Meseguer,ESP,MF,Valladolid,La Liga,25,1999,4.6,10,6,4,4,2,2,10,20,8,3,0,3,2,12,4,1
Rafik Messali,FRA,DF,Toulouse,Ligue 1,21,2003,5.1,15,8,6,6,3,7,8,87.5,1,9,1,8,10,25,12,0
Junior Messias,BRA,"MF,FW",Genoa,Serie A,33,1991,9.4,13,7,6,6,1,3,10,30,7,8,2,6,6,19,20,0
Connor Metcalfe,AUS,"MF,FW",St. Pauli,Bundesliga,24,1999,4,2,0,1,1,0,0,5,0,5,4,0,4,3,5,8,0
Karol Mets,EST,DF,St. Pauli,Bundesliga,31,1993,10,13,8,6,7,0,4,7,57.1,3,9,3,6,12,25,60,0
Thomas Meunier,BEL,DF,Lille,Ligue 1,32,1991,21.4,53,38,32,15,6,33,49,67.3,16,21,8,13,34,87,64,0
Alexander Meyer,GER,GK,Dortmund,Bundesliga,33,1991,2,0,0,0,0,0,0,0,,0,0,0,0,0,0,0,0
Shumaira Mheuka,ENG,MF,Chelsea,Premier League,16,2007,0,0,0,0,0,0,0,0,,0,0,0,0,0,0,0,0
Lucas Michal,FRA,"FW,MF",Monaco,Ligue 1,19,2005,1.3,5,3,3,2,0,2,4,50,2,2,0,2,1,6,2,0
Florian Micheler,AUT,MF,Hoffenheim,Bundesliga,19,2005,0.4,0,0,0,0,0,0,2,0,2,0,0,0,0,0,0,0
Miguel,ESP,FW,Leganés,La Liga,24,1999,19.2,16,7,6,4,6,4,14,28.6,10,15,4,11,4,20,23,1
Valentin Mihaila,ROU,"FW,MF",Parma,Serie A,24,2000,14.3,29,15,8,13,8,9,22,40.9,13,18,0,18,8,37,6,0
Georges Mikautadze,GEO,FW,Lyon,Ligue 1,23,2000,16.1,7,6,1,3,3,3,9,33.3,6,11,0,11,4,11,6,0
Igor Miladinović,SRB,"FW,MF",Saint-Étienne,Ligue 1,21,2003,0.3,0,0,0,0,0,0,0,,0,0,0,0,1,1,1,0
Nikola Milenković,SRB,DF,Nott'ham Forest,Premier League,26,1997,37,51,29,36,13,2,27,34,79.4,7,41,24,17,27,78,209,1
Lewis Miley,ENG,MF,Newcastle Utd,Premier League,18,2006,3.5,14,11,5,7,2,7,14,50,7,5,1,4,2,16,5,2
Vanja Milinković-Savić,SRB,GK,Torino,Serie A,27,1997,37,1,0,1,0,0,1,3,33.3,2,0,0,0,0,1,18,4
Éder Militão,BRA,DF,Real Madrid,La Liga,26,1998,10.4,19,17,14,5,0,7,12,58.3,5,13,8,5,12,31,35,0
Luis Milla,ESP,MF,Getafe,La Liga,29,1994,31.9,61,40,28,25,8,35,72,48.6,37,25,0,25,24,85,28,3
Pere Milla,ESP,"MF,FW",Espanyol,La Liga,31,1992,5.1,6,2,5,0,1,1,18,5.6,17,10,2,8,3,9,5,0
Enzo Millot,FRA,"MF,FW",Stuttgart,Bundesliga,22,2002,20.5,30,13,10,15,5,12,35,34.3,23,27,0,27,13,43,6,1
James Milner,ENG,MF,Brighton,Premier League,38,1986,1.9,5,2,1,3,1,3,3,100,0,4,2,2,2,7,2,1
Kim Min-jae,KOR,DF,Bayern Munich,Bundesliga,27,1996,25.4,35,20,18,13,4,11,21,52.4,10,23,10,13,37,72,91,4
Yerry Mina,COL,DF,Cagliari,Serie A,29,1994,28.5,66,32,43,21,2,40,52,76.9,12,59,35,24,37,103,163,3
Takumi Minamino,JPN,"MF,FW",Monaco,Ligue 1,29,1995,24.8,33,19,7,14,12,15,42,35.7,27,26,1,25,10,43,20,0
Lucas Mincarelli,FRA,DF,Montpellier,Ligue 1,20,2004,7.9,17,10,6,9,2,6,13,46.2,7,8,5,3,9,26,27,0
Tyrone Mings,ENG,DF,Aston Villa,Premier League,31,1993,12.4,7,6,6,1,0,2,2,100,0,13,11,2,7,14,61,1
Óscar Mingueza,ESP,"MF,DF",Celta Vigo,La Liga,25,1999,30.3,38,24,21,12,5,26,69,37.7,43,35,5,30,22,60,46,7
Kim Minsu,KOR,"MF,FW",Girona,La Liga,18,2006,0.2,1,0,0,1,0,0,0,,0,0,0,0,0,1,0,0
Yankuba Minteh,GAM,"FW,MF",Brighton,Premier League,20,2004,20.4,48,35,25,13,10,17,45,37.8,28,22,0,22,11,59,31,0
Bojan Miovski,MKD,FW,Girona,La Liga,25,1999,9.7,7,5,2,2,3,2,7,28.6,5,4,0,4,2,9,7,0
Rafa Mir,ESP,"FW,MF",Valencia,La Liga,27,1997,8.4,12,6,8,4,0,3,9,33.3,6,5,0,5,5,17,9,0
Juan Miranda,ESP,DF,Bologna,Serie A,24,2000,25.3,32,18,11,14,7,14,33,42.4,19,21,3,18,23,55,50,1
Fabio Miretti,ITA,"MF,FW",Genoa,Serie A,20,2003,18.6,28,15,6,14,8,18,33,54.5,15,20,1,19,7,35,13,2
Tyrick Mitchell,ENG,DF,Crystal Palace,Premier League,24,1999,34.4,91,55,57,27,7,25,46,54.3,21,68,12,56,19,110,108,2
Kaoru Mitoma,JPN,"FW,MF",Brighton,Premier League,27,1997,28.9,45,27,15,14,16,19,49,38.8,30,48,3,45,14,59,10,0
Maximilian Mittelstädt,GER,DF,Stuttgart,Bundesliga,27,1997,27.4,79,54,42,30,7,53,73,72.6,20,47,11,36,47,126,96,2
Koji Miyoshi,JPN,"FW,MF",Bochum,Bundesliga,27,1997,5.2,8,5,2,1,5,4,9,44.4,5,10,1,9,2,10,2,0
Henrikh Mkhitaryan,ARM,MF,Inter,Serie A,35,1989,25.9,43,24,17,16,10,20,45,44.4,25,29,5,24,16,59,41,0
Jakub Moder,POL,MF,Brighton,Premier League,25,1999,0.1,1,0,1,0,0,0,2,0,2,0,0,0,0,1,3,0
Rui Modesto,ANG,"DF,MF",Udinese,Serie A,24,1999,6.8,16,12,4,9,3,7,9,77.8,2,10,0,10,8,24,13,0
Luka Modrić,CRO,MF,Real Madrid,La Liga,38,1985,20.3,31,20,16,13,2,14,32,43.8,18,17,5,12,27,58,17,0
Max Moerstedt,GER,FW,Hoffenheim,Bundesliga,,,5,5,5,1,3,1,1,2,50,1,4,0,4,0,5,5,0
Terem Moffi,NGA,FW,Nice,Ligue 1,25,1999,0.6,0,0,0,0,0,0,0,,0,0,0,0,0,0,0,0
Mostafa Mohamed,EGY,FW,Nantes,Ligue 1,26,1997,13.9,18,9,6,8,4,4,12,33.3,8,10,2,8,10,28,27,0
Johan Mojica,COL,DF,Mallorca,La Liga,31,1992,30.6,35,23,26,6,3,19,40,47.5,21,13,5,8,26,61,84,3
David Mokwa,FRA,"DF,FW",Hoffenheim,Bundesliga,20,2004,0.2,1,0,1,0,0,0,0,,0,0,0,0,0,1,0,0
Alberto Moleiro,ESP,"FW,MF",Las Palmas,La Liga,20,2003,30.2,27,12,12,14,1,18,48,37.5,30,24,0,24,18,45,8,0
Nahuel Molina,ARG,DF,Atlético Madrid,La Liga,26,1998,17.7,44,19,21,21,2,31,56,55.4,25,16,3,13,13,57,53,0
Florent Mollet,FRA,"MF,FW",Nantes,Ligue 1,32,1991,2.7,2,2,1,1,0,1,1,100,0,2,0,2,1,3,4,0
Jon Moncayola,ESP,MF,Osasuna,La Liga,26,1998,23.3,70,41,29,33,8,31,60,51.7,29,34,3,31,11,81,20,0
Jeremy Monga,,"FW,MF",Leicester City,Premier League,,,1.2,2,1,0,1,1,1,1,100,0,3,2,1,0,2,1,0
Gonzalo Montiel,ARG,"DF,MF",Sevilla,La Liga,27,1997,1.3,4,2,3,1,0,3,4,75,1,0,0,0,2,6,11,0
Lorenzo Montipò,ITA,GK,Hellas Verona,Serie A,28,1996,36,1,0,1,0,0,1,4,25,3,0,0,0,0,1,24,4
Mikey Moore,ENG,FW,Tottenham,Premier League,16,2007,4.1,2,1,2,0,0,0,4,0,4,2,0,2,1,3,5,0
Álvaro Morata,ESP,"FW,MF",Milan,Serie A,31,1992,12.2,16,10,5,8,3,5,8,62.5,3,7,2,5,5,21,5,0
Morato,BRA,DF,Nott'ham Forest,Premier League,23,2001,10.1,22,14,18,3,1,13,21,61.9,8,14,5,9,10,32,78,2
Diego Moreira,POR,"DF,MF",Strasbourg,Ligue 1,19,2004,28.5,44,28,17,19,8,24,50,48,26,23,4,19,35,79,65,0
Alberto Moreno,ESP,DF,Como,Serie A,32,1992,19.2,25,11,17,8,0,12,26,46.2,14,12,3,9,14,39,40,2
Álex Moreno,ESP,"DF,MF",Nott'ham Forest,Premier League,31,1993,10.6,25,18,20,5,0,15,39,38.5,24,11,5,6,15,40,43,0
Gerard Moreno,ESP,FW,Villarreal,La Liga,32,1992,8,7,4,3,2,2,3,12,25,9,0,0,0,2,9,8,0
Matias Moreno,ARG,DF,Fiorentina,Serie A,20,2003,1.6,8,8,5,3,0,4,4,100,0,5,1,4,1,9,9,0
Xavier Moreno,ESP,FW,Valladolid,La Liga,19,2004,0.5,0,0,0,0,0,0,0,,0,0,0,0,0,0,1,0
Tete Morente,ESP,"FW,MF",Lecce,Serie A,27,1996,22.5,27,17,10,11,6,10,36,27.8,26,16,1,15,14,41,31,1
Mateu Morey,ESP,DF,Mallorca,La Liga,24,2000,8.2,22,18,13,6,3,12,22,54.5,10,11,0,11,15,37,32,2
Ilaix Moriba,GUI,MF,Celta Vigo,La Liga,21,2003,23.7,68,42,24,30,14,32,57,56.1,25,29,4,25,14,82,33,1
Manu Morlanes,ESP,MF,Mallorca,La Liga,25,1999,14.9,43,27,18,20,5,18,30,60,12,19,8,11,24,67,16,0
Nikola Moro,CRO,MF,Bologna,Serie A,26,1998,13.4,35,27,7,21,7,22,33,66.7,11,18,7,11,13,48,18,0
Raúl Moro,ESP,"MF,FW",Valladolid,La Liga,21,2002,26,22,13,15,4,3,13,32,40.6,19,8,0,8,10,32,20,1
Sam Morsy,EGY,MF,Ipswich Town,Premier League,32,1991,30.6,68,41,40,24,4,27,62,43.5,35,34,13,21,29,97,47,5
Gabriel Moscardo,BRA,"MF,DF",Reims,Ligue 1,18,2005,0.9,3,1,2,1,0,1,3,33.3,2,3,1,2,0,3,1,0
Cristhian Mosquera,ESP,DF,Valencia,La Liga,20,2004,36.9,56,36,41,13,2,31,40,77.5,9,37,24,13,35,91,128,4
Daniel Mosquera,COL,FW,Hellas Verona,Serie A,24,1999,15.3,11,8,3,5,3,1,15,6.7,14,11,1,10,2,13,10,0
Yerson Mosquera,COL,DF,Wolves,Premier League,23,2001,4.9,11,7,9,2,0,9,14,64.3,5,13,10,3,10,21,14,0
Dany Mota,POR,"FW,MF",Monza,Serie A,26,1998,23.4,13,3,2,3,8,4,8,50,4,18,1,17,9,22,27,3
Yael Mouanga,FRA,DF,Montpellier,Ligue 1,19,2005,10.5,14,8,9,3,2,7,9,77.8,2,16,8,8,10,24,50,0
Aimen Moueffek,FRA,MF,Saint-Étienne,Ligue 1,23,2001,11.5,20,12,3,11,6,10,23,43.5,13,20,7,13,5,25,26,1
Youssoufa Moukoko,GER,"FW,MF",Nice,Ligue 1,19,2004,2.3,3,2,2,1,0,1,2,50,1,2,0,2,0,3,0,0
Steve Mounié,BEN,"FW,MF",Augsburg,Bundesliga,29,1994,3.9,4,4,0,1,3,0,1,0,1,1,1,0,1,5,5,1
Mason Mount,ENG,MF,Manchester Utd,Premier League,25,1999,6.9,15,5,5,8,2,9,12,75,3,11,1,10,4,19,4,0
Santiago Mouriño,URU,DF,Alavés,La Liga,22,2002,20.5,43,28,31,12,0,21,38,55.3,17,27,12,15,29,72,120,0
Louis Mouton,FRA,MF,Saint-Étienne,Ligue 1,22,2002,11.6,49,25,14,25,10,22,37,59.5,15,17,3,14,10,59,19,0
Divin Mubama,ENG,FW,Manchester City,Premier League,19,2004,0.3,0,0,0,0,0,0,0,,0,0,0,0,0,0,0,0
Mykhailo Mudryk,UKR,FW,Chelsea,Premier League,23,2001,1.7,2,2,2,0,0,0,0,,0,3,1,2,0,2,1,0
Ngal'Ayel Mukau,COD,MF,Lille,Ligue 1,19,2004,13.2,33,18,9,22,2,17,29,58.6,12,14,0,14,15,48,22,0
Nordi Mukiele,FRA,DF,Leverkusen,Bundesliga,26,1997,10,20,16,8,8,4,12,18,66.7,6,10,0,10,16,36,37,2
Florian Müller,GER,GK,Freiburg,Bundesliga,26,1997,8.4,0,0,0,0,0,0,0,,0,0,0,0,0,0,3,0
Kevin Müller,GER,GK,Heidenheim,Bundesliga,33,1991,32.7,3,2,3,0,0,3,3,100,0,0,0,0,0,3,13,4
Marius Müller,GER,GK,Wolfsburg,Bundesliga,31,1993,5.3,0,0,0,0,0,0,0,,0,0,0,0,0,0,0,0
Thomas Müller,GER,"MF,FW",Bayern Munich,Bundesliga,34,1989,13.6,8,5,2,3,3,4,16,25,12,10,0,10,2,10,14,0
Abdul Mumin,GHA,DF,Rayo Vallecano,La Liga,26,1998,22.4,37,25,30,7,0,17,27,63,10,40,29,11,23,60,125,0
Marshall Munetsi,ZIM,"MF,FW",Wolves,Premier League,28,1996,12,24,10,7,11,6,13,23,56.5,10,14,1,13,6,30,18,0
Marshall Munetsi,ZIM,MF,Reims,Ligue 1,28,1996,18.8,36,18,22,9,5,22,38,57.9,16,27,3,24,17,53,35,0
Rodrigo Muniz,BRA,FW,Fulham,Premier League,23,2001,10.7,10,5,3,5,2,4,4,100,0,9,2,7,5,15,14,0
Aihen Muñoz,ESP,DF,Real Sociedad,La Liga,26,1997,12.2,24,12,14,8,2,14,28,50,14,11,6,5,14,38,47,0
Álex Muñoz,ESP,DF,Las Palmas,La Liga,30,1994,15.7,39,29,22,16,1,21,38,55.3,17,28,11,17,16,55,69,0
Daniel Muñoz,COL,DF,Crystal Palace,Premier League,28,1996,35.9,123,80,57,41,25,55,96,57.3,41,40,6,34,44,167,108,1
Iker Muñoz,ESP,MF,Osasuna,La Liga,21,2002,6.8,5,2,3,2,0,3,9,33.3,6,9,2,7,4,9,12,1
Javier Muñoz,ESP,"MF,DF",Las Palmas,La Liga,29,1995,28.8,45,35,18,17,10,16,46,34.8,30,27,4,23,31,76,39,3
Víctor Muñoz,ESP,"FW,DF",Real Madrid,La Liga,21,2003,0.4,0,0,0,0,0,0,0,,0,0,0,0,0,0,0,0
Arijanet Muric,KVX,GK,Ipswich Town,Premier League,25,1998,18,0,0,0,0,0,0,2,0,2,0,0,0,0,0,10,5
Murillo,BRA,DF,Nott'ham Forest,Premier League,22,2002,35.4,53,36,38,12,3,27,46,58.7,19,69,45,24,36,89,249,3
Vedat Muriqi,KVX,FW,Mallorca,La Liga,30,1994,22.9,7,5,3,2,2,3,7,42.9,4,7,1,6,7,14,43,0
Jacob Murphy,ENG,FW,Newcastle Utd,Premier League,29,1995,26.2,28,19,10,12,6,20,44,45.5,24,31,0,31,13,41,35,1
Bob Murphy Omoregbe,ITA,MF,Milan,Serie A,20,2003,0,0,0,0,0,0,0,0,,0,0,0,0,0,0,0,0
Yunus Musah,USA,"MF,FW",Milan,Serie A,21,2002,17.5,27,19,13,9,5,12,17,70.6,5,9,1,8,7,34,9,3
Jamal Musiala,GER,MF,Bayern Munich,Bundesliga,21,2003,20,36,21,7,16,13,12,29,41.4,17,30,0,30,8,44,5,1
Florent Muslija,KVX,"FW,MF",Freiburg,Bundesliga,26,1998,1.9,5,4,3,1,1,2,2,100,0,0,0,0,1,6,1,0
Almoatasem Al Musrati,LBY,MF,Monaco,Ligue 1,28,1996,4.3,14,11,5,8,1,7,11,63.6,4,3,1,2,5,19,9,0
Juan Musso,ARG,GK,Atalanta,Serie A,30,1994,1,0,0,0,0,0,0,0,,0,0,0,0,0,0,0,0
Juan Musso,ARG,GK,Atlético Madrid,La Liga,30,1994,2,0,0,0,0,0,0,0,,0,0,0,0,0,0,0,0
Kingstone Mutandwa,ZAM,"FW,MF",Cagliari,Serie A,21,2003,1.4,0,0,0,0,0,0,0,,0,0,0,0,0,0,0,0
Junior Mwanga,FRA,MF,Le Havre,Ligue 1,21,2003,10.6,26,16,10,13,3,11,19,57.9,8,10,3,7,8,34,18,2
Junior Mwanga,FRA,MF,Strasbourg,Ligue 1,21,2003,3.3,17,9,9,7,1,5,9,55.6,4,2,0,2,2,19,2,0
Phillipp Mwene,AUT,DF,Mainz 05,Bundesliga,30,1994,29,51,29,23,22,6,19,46,41.3,27,27,6,21,24,75,51,1
Vitaliy Mykolenko,UKR,DF,Everton,Premier League,25,1999,34.2,63,38,39,14,10,29,56,51.8,27,25,10,15,44,107,145,2
Joakim Mæhle,DEN,DF,Wolfsburg,Bundesliga,27,1997,24.3,34,15,26,6,2,17,45,37.8,28,24,3,21,25,59,57,2
Obite N'Dicka,CIV,DF,Roma,Serie A,24,1999,38,32,26,17,15,0,14,21,66.7,7,46,30,16,33,65,150,2
Konan N'dri,CIV,"FW,MF",Lecce,Serie A,23,2000,3.4,3,3,0,0,3,2,3,66.7,1,4,0,4,1,4,0,0
Loïc N'Gatta,FRA,DF,Auxerre,Ligue 1,20,2003,0.1,1,1,0,1,0,1,2,50,1,1,0,1,0,1,1,0
Nathan N'Goumou,CMR,FW,Gladbach,Bundesliga,24,2000,9.2,17,11,11,4,2,6,11,54.5,5,8,2,6,4,21,16,0
Djylian N'Guessan,FRA,FW,Saint-Étienne,Ligue 1,15,2008,2,6,4,5,1,0,2,5,40,3,1,0,1,0,6,1,0
Stanley N'Soki,FRA,DF,Hoffenheim,Bundesliga,25,1999,14.5,22,16,13,7,2,12,23,52.2,11,22,7,15,26,48,58,3
Mickael Nade,FRA,DF,Saint-Étienne,Ligue 1,25,1999,25.6,59,43,40,19,0,28,36,77.8,8,37,19,18,33,92,132,8
Bilal Nadir,MAR,MF,Marseille,Ligue 1,20,2003,4.3,10,3,4,6,0,4,6,66.7,2,6,1,5,4,14,7,0
Mahamadou Nagida,CMR,DF,Rennes,Ligue 1,19,2005,4.8,8,6,4,3,1,4,5,80,1,3,0,3,9,17,6,0
Keito Nakamura,JPN,"FW,MF",Reims,Ligue 1,24,2000,29.4,24,16,7,10,7,11,31,35.5,20,21,1,20,13,37,19,0
Sebastian Nanasi,SWE,"MF,FW",Strasbourg,Ligue 1,22,2002,23.4,20,13,6,12,2,8,22,36.4,14,24,3,21,7,27,18,0
Yael Nandjou,FRA,DF,Nice,Ligue 1,19,2005,1.7,4,1,2,1,1,4,8,50,4,4,1,3,4,8,7,0
Nikolas Nartey,DEN,MF,Stuttgart,Bundesliga,24,2000,0.2,0,0,0,0,0,0,0,,0,0,0,0,0,0,4,0
Matija Nastasić,SRB,DF,Leganés,La Liga,31,1993,23.4,25,11,21,4,0,17,25,68,8,39,30,9,21,46,165,0
Natan,BRA,DF,Betis,La Liga,23,2001,24.2,35,24,24,9,2,26,30,86.7,4,24,14,10,28,63,123,2
Pau Navarro,ESP,DF,Villarreal,La Liga,19,2005,10.2,23,17,15,6,2,19,39,48.7,20,13,6,7,4,27,41,0
Roberto Navarro,ESP,"MF,FW",Mallorca,La Liga,22,2002,14.2,29,22,14,11,4,9,19,47.4,10,18,0,18,19,48,12,0
Jesús Navas,ESP,"FW,MF",Sevilla,La Liga,38,1985,4.7,5,2,3,0,2,0,3,0,3,1,0,1,4,9,6,0
Michel Ndary Adopo,FRA,MF,Cagliari,Serie A,24,2000,26.8,55,32,16,31,8,15,29,51.7,14,20,5,15,27,82,25,0
Youssouf Ndayishimiye,BDI,DF,Nice,Ligue 1,25,1998,21.5,40,21,25,14,1,16,27,59.3,11,35,19,16,21,61,117,4
Iliman Ndiaye,SEN,FW,Everton,Premier League,24,2000,27,53,28,20,16,17,22,49,44.9,27,30,5,25,20,73,24,1
Junior Ndiaye,FRA,FW,Montpellier,Ligue 1,19,2005,4.9,3,2,2,1,0,1,4,25,3,2,1,1,0,3,2,0
Rassoul Ndiaye,SEN,MF,Le Havre,Ligue 1,22,2001,11.8,35,25,19,12,4,11,25,44,14,15,4,11,12,47,24,0
Wilfred Ndidi,NGA,MF,Leicester City,Premier League,27,1996,25.8,85,51,45,32,8,30,61,49.2,31,47,19,28,31,116,80,0
Wilfried Ndollo,CMR,DF,Montpellier,Ligue 1,19,2005,4.5,6,5,4,1,1,4,8,50,4,9,1,8,7,13,11,0
Tanguy Ndombele,FRA,MF,Nice,Ligue 1,27,1996,12.6,35,23,10,21,4,12,20,60,8,9,0,9,14,49,9,0
Cher Ndour,ITA,"MF,DF",Fiorentina,Serie A,20,2004,4.5,4,1,2,1,1,2,10,20,8,5,1,4,2,6,7,1
Dan Ndoye,SUI,FW,Bologna,Serie A,23,2000,23.8,26,19,8,8,10,16,28,57.1,12,23,0,23,9,35,4,0
Paul Nebel,GER,MF,Mainz 05,Bundesliga,21,2002,26.1,38,24,11,18,9,11,35,31.4,24,54,4,50,13,51,30,2
Kosta Nedeljković,SRB,DF,Aston Villa,Premier League,18,2005,1.4,7,5,1,3,3,2,3,66.7,1,1,0,1,0,7,3,0
Kosta Nedeljković,SRB,DF,RB Leipzig,Bundesliga,18,2005,5.3,11,8,5,6,0,6,10,60,4,6,4,2,2,13,14,0
Loïc Nego,HUN,"DF,FW",Le Havre,Ligue 1,33,1991,27.3,58,35,37,16,5,41,64,64.1,23,17,3,14,29,87,82,0
Ivan Nekić,CRO,DF,Holstein Kiel,Bundesliga,23,2000,0.8,1,1,1,0,0,1,2,50,1,1,0,1,3,4,2,0
Reiss Nelson,ENG,FW,Arsenal,Premier League,24,1999,0,1,0,0,1,0,0,1,0,1,0,0,0,0,1,1,0
Reiss Nelson,ENG,FW,Fulham,Premier League,24,1999,5.4,8,6,3,3,2,5,13,38.5,8,11,0,11,5,13,2,0
Victor Nelsson,DEN,DF,Roma,Serie A,25,1998,2.1,5,4,3,1,1,3,5,60,2,1,0,1,2,7,9,0
David Nemeth,AUT,DF,St. Pauli,Bundesliga,23,2001,23.7,43,29,25,16,2,25,43,58.1,18,29,11,18,18,61,94,2
David Neres,BRA,FW,Napoli,Serie A,27,1997,14.3,21,11,10,4,7,10,15,66.7,5,7,0,7,7,28,4,0
Neto,BRA,GK,Bournemouth,Premier League,35,1989,2,0,0,0,0,0,0,0,,0,0,0,0,0,0,1,1
Pedro Neto,POR,FW,Chelsea,Premier League,24,2000,25.2,23,9,9,9,5,9,21,42.9,12,14,2,12,9,32,6,0
Luca Netz,GER,DF,Gladbach,Bundesliga,21,2003,10.8,24,14,14,8,2,13,19,68.4,6,17,4,13,10,34,36,0
Manuel Neuer,GER,GK,Bayern Munich,Bundesliga,38,1986,22,1,0,1,0,0,1,1,100,0,0,0,0,0,1,9,1
Florian Neuhaus,GER,MF,Gladbach,Bundesliga,27,1997,4.2,10,3,7,3,0,7,17,41.2,10,9,2,7,6,16,5,1
João Neves,POR,"MF,DF",Paris S-G,Ligue 1,19,2004,20.5,63,31,20,26,17,27,45,60,18,29,9,20,23,86,22,1
Yvan Neyou,CMR,MF,Leganés,La Liga,27,1997,25.7,53,33,21,26,6,22,47,46.8,25,35,5,30,26,79,38,1
Cyril Ngonge,BEL,FW,Napoli,Serie A,24,2000,2.4,8,5,4,4,0,4,7,57.1,3,3,0,3,2,10,4,0
Mikayil Ngor Faye,SEN,DF,Rennes,Ligue 1,20,2004,7.6,15,12,10,3,2,7,9,77.8,2,9,4,5,12,27,30,0
Steve Ngoura,FRA,FW,Le Havre,Ligue 1,19,2005,3.2,4,2,1,1,2,3,3,100,0,2,1,1,0,4,2,0
Bernard Nguene,CMR,FW,Nice,Ligue 1,17,2006,0.1,0,0,0,0,0,0,0,,0,0,0,0,0,0,0,0
Moussa Niakhate,SEN,DF,Lyon,Ligue 1,28,1996,30.3,47,27,37,8,2,24,32,75,8,26,17,9,25,72,143,3
Abdoulaye Niakhate Ndiaye,SEN,DF,Brest,Ligue 1,22,2002,19,49,33,36,12,1,25,37,67.6,12,29,17,12,11,60,144,3
Ibrahima Niane,SEN,FW,Angers,Ligue 1,25,1999,10.5,7,3,3,2,2,3,3,100,0,6,1,5,2,9,6,2
Tanguy Nianzou,FRA,DF,Sevilla,La Liga,22,2002,5.8,7,5,6,0,1,5,6,83.3,1,1,0,1,8,15,27,0
Rasmus Nicolaisen,DEN,DF,Toulouse,Ligue 1,27,1997,6.9,6,3,4,2,0,3,5,60,2,10,5,5,10,16,25,0
Moritz Nicolas,GER,GK,Gladbach,Bundesliga,26,1997,18.2,0,0,0,0,0,0,0,,0,1,0,1,1,1,8,1
Hans Nicolussi Caviglia,ITA,MF,Venezia,Serie A,24,2000,31.8,47,28,17,22,8,29,64,45.3,35,39,12,27,28,75,55,2
Julian Niehues,GER,MF,Heidenheim,Bundesliga,23,2001,1.7,3,1,3,0,0,1,5,20,4,1,0,1,0,3,8,0
Oliver Nielsen,DEN,DF,Lazio,Serie A,21,2003,0.4,0,0,0,0,0,0,0,,0,1,0,1,1,1,2,0
Saúl Ñíguez,ESP,MF,Sevilla,La Liga,29,1994,17.3,47,32,16,24,7,12,31,38.7,19,25,2,23,22,69,34,0
Eybi Nije,SWE,"FW,MF",Torino,Serie A,19,2005,4.4,5,1,3,1,1,0,3,0,3,5,1,4,0,5,1,0
Tamás Nikitscher,HUN,"MF,DF",Valladolid,La Liga,24,1999,9.5,17,8,8,9,0,8,13,61.5,5,17,4,13,11,28,16,1
Adrian Niño,ESP,FW,Atlético Madrid,La Liga,20,2004,0.1,0,0,0,0,0,0,0,,0,0,0,0,0,0,0,0
Justin Njinmah,GER,"FW,MF",Werder Bremen,Bundesliga,23,2000,10.6,6,2,1,4,1,3,5,60,2,5,0,5,3,9,1,0
Eddie Nketiah,ENG,"FW,MF",Crystal Palace,Premier League,25,1999,11.5,15,8,7,4,4,6,12,50,6,10,1,9,3,18,12,0
Niels Nkounkou,FRA,"DF,MF",Eint Frankfurt,Bundesliga,23,2000,4.2,13,10,7,3,3,4,7,57.1,3,5,2,3,7,20,15,0
Christopher Nkunku,FRA,FW,Chelsea,Premier League,26,1997,10.2,12,8,3,4,5,6,8,75,2,9,2,7,7,19,10,0
Felix Nmecha,GER,MF,Dortmund,Bundesliga,23,2000,16.8,34,22,6,19,9,12,22,54.5,10,20,5,15,23,57,30,1
Lukas Nmecha,GER,"FW,MF",Wolfsburg,Bundesliga,25,1998,5.2,2,0,1,1,0,0,1,0,1,3,0,3,2,4,4,0
Arnaud Nordin,FRA,FW,Montpellier,Ligue 1,26,1998,13,24,15,6,16,2,11,21,52.4,10,12,0,12,5,29,7,0
Arnaud Nordin,FRA,"DF,MF",Mainz 05,Bundesliga,26,1998,0.9,2,0,0,2,0,1,1,100,0,2,1,1,0,2,2,0
Brooke Norton-Cuffy,ENG,"DF,FW",Genoa,Serie A,20,2004,8,12,7,9,3,0,9,11,81.8,2,12,2,10,3,15,12,0
Tijjani Noslin,NED,"FW,MF",Lazio,Serie A,25,1999,9.6,6,5,2,1,3,1,8,12.5,7,15,1,14,1,7,7,0
Hugo Novoa,ESP,"DF,MF",Alavés,La Liga,21,2003,2.6,8,5,4,3,1,5,5,100,0,2,1,1,0,8,6,0
Plamedi Nsingi,,MF,Nantes,Ligue 1,23,2000,0.2,1,0,1,0,0,0,1,0,1,0,0,0,0,1,0,0
Randy Nteka,ANG,FW,Rayo Vallecano,La Liga,26,1997,12.5,16,5,3,9,4,5,12,41.7,7,13,2,11,4,20,20,0
Ernest Nuamah,GHA,"FW,MF",Lyon,Ligue 1,20,2003,11.7,21,11,15,4,2,12,27,44.4,15,9,1,8,8,29,8,1
Alexander Nübel,GER,GK,Stuttgart,Bundesliga,27,1996,34,0,0,0,0,0,0,1,0,1,0,0,0,0,0,18,3
Gustavo Nunes,BRA,"FW,MF",Brentford,Premier League,18,2005,0.1,3,2,2,0,1,2,2,100,0,0,0,0,0,3,2,0
Matheus Nunes,POR,"DF,MF",Manchester City,Premier League,25,1998,18.6,35,22,15,14,6,16,38,42.1,22,17,4,13,15,50,38,2
Darwin Núñez,URU,FW,Liverpool,Premier League,25,1999,12.6,21,18,11,4,6,7,18,38.9,11,6,0,6,4,25,12,0
Unai Núñez,ESP,DF,Athletic Club,La Liga,27,1997,7.2,10,5,7,3,0,4,7,57.1,3,4,4,0,17,27,46,1
Antonio Nusa,NOR,"MF,DF",RB Leipzig,Bundesliga,19,2005,17.3,30,17,16,9,5,18,36,50,18,22,2,20,8,38,11,0
Ethan Nwaneri,ENG,"FW,MF",Arsenal,Premier League,17,2007,9.9,11,7,4,4,3,7,21,33.3,14,8,2,6,2,13,4,1
Ørjan Nyland,NOR,GK,Sevilla,La Liga,33,1990,29.7,3,2,3,0,0,3,5,60,2,0,0,0,0,3,12,4
Allan Nyom,CMR,"DF,MF",Getafe,La Liga,36,1988,9.9,18,11,7,9,2,15,17,88.2,2,4,2,2,4,22,23,0
Rabby Nzingoula,CGO,MF,Montpellier,Ligue 1,18,2005,18.8,64,42,26,31,7,27,58,46.6,31,27,5,22,29,93,23,0
M'Bala Nzola,ANG,FW,Lens,Ligue 1,27,1996,16.2,5,4,0,1,4,3,9,33.3,6,9,1,8,5,10,7,0
Marwann Nzuzi,FRA,DF,Saint-Étienne,Ligue 1,20,2004,1.4,2,2,1,0,1,1,2,50,1,0,0,0,2,4,6,0
Christian Nørgaard,DEN,MF,Brentford,Premier League,30,1994,31.3,79,49,37,35,7,48,81,59.3,33,52,20,32,49,128,70,1
Jake O'Brien,IRL,DF,Everton,Premier League,23,2001,17.5,26,17,21,5,0,17,25,68,8,17,4,13,4,30,93,0
Matt O'Riley,DEN,MF,Brighton,Premier League,23,2000,10.4,16,9,4,8,4,4,13,30.8,9,7,3,4,13,29,9,1
Dara O'Shea,IRL,DF,Ipswich Town,Premier League,25,1999,34.7,49,31,33,13,3,22,34,64.7,12,62,50,12,33,82,225,4
Adam Obert,SVK,DF,Cagliari,Serie A,21,2002,12,31,18,12,17,2,16,27,59.3,11,19,7,12,23,54,48,2
Chidozie Obi-Martin,DEN,FW,Manchester Utd,Premier League,16,2007,1.8,2,1,0,0,2,2,2,100,0,0,0,0,0,2,1,0
Jan Oblak,SVN,GK,Atlético Madrid,La Liga,31,1993,36,0,0,0,0,0,0,0,,0,0,0,0,0,0,17,2
Lucas Ocampos,ARG,FW,Sevilla,La Liga,30,1994,1.9,3,2,2,0,1,1,2,50,1,2,0,2,0,3,2,0
Jens Odgaard,DEN,"MF,FW",Bologna,Serie A,25,1999,21.7,20,14,3,12,5,6,21,28.6,15,19,2,17,9,29,12,1
Wilson Odobert,FRA,"FW,MF",Tottenham,Premier League,19,2004,9.4,14,5,5,4,5,8,14,57.1,6,6,0,6,4,18,5,1
David Odogu,GER,DF,Wolfsburg,Bundesliga,18,2006,2.2,6,4,4,2,0,3,5,60,2,2,2,0,2,8,25,1
Álvaro Odriozola,ESP,DF,Real Sociedad,La Liga,28,1995,0.5,1,1,1,0,0,0,0,,0,0,0,0,0,1,1,0
Tim Oermann,GER,DF,Bochum,Bundesliga,20,2003,24.6,50,31,25,21,4,26,43,60.5,17,32,16,16,22,72,64,0
Chiedozie Ogbene,IRL,FW,Ipswich Town,Premier League,27,1997,2.6,7,3,1,2,4,2,4,50,2,1,0,1,1,8,3,0
Ifechukwu Ogbus,SUI,DF,Freiburg,Bundesliga,18,2005,0.2,1,1,0,0,1,0,1,0,1,0,0,0,1,2,2,0
Thiago Ojeda,ARG,MF,Villarreal,La Liga,21,2003,0.1,0,0,0,0,0,0,0,,0,0,0,0,0,0,1,0
Hamzat Ojediran,NGA,"MF,FW",Lens,Ligue 1,20,2003,4.6,28,15,12,13,3,7,19,36.8,12,10,2,8,10,38,7,0
Noah Okafor,SUI,FW,Milan,Serie A,24,2000,4.6,2,1,0,0,2,0,1,0,1,1,0,1,2,4,1,0
Noah Okafor,SUI,"FW,MF",Napoli,Serie A,24,2000,0.4,3,2,3,0,0,2,2,100,0,0,0,0,0,3,1,0
Caleb Okoli,ITA,DF,Leicester City,Premier League,23,2001,12.5,25,14,8,15,2,11,18,61.1,7,24,14,10,15,40,79,3
Yllan Okou,FRA,DF,Hellas Verona,Serie A,21,2002,0,0,0,0,0,0,0,0,,0,1,0,1,0,0,0,0
Maduka Okoye,NGA,GK,Udinese,Serie A,24,1999,25,0,0,0,0,0,0,0,,0,0,0,0,0,0,12,1
Joseph Okumu,KEN,DF,Reims,Ligue 1,27,1997,18.8,30,15,21,9,0,15,24,62.5,9,33,21,12,25,55,137,2
Aingeru Olabarrieta,ESP,FW,Athletic Club,La Liga,18,2005,0.6,0,0,0,0,0,0,0,,0,2,0,2,1,1,1,0
Kazeem Olaigbe,BEL,"MF,FW",Rennes,Ligue 1,21,2003,3.3,6,4,3,3,0,3,6,50,3,3,1,2,0,6,0,0
Olasagasti,ESP,MF,Real Sociedad,La Liga,23,2000,9.5,21,10,7,9,5,8,18,44.4,10,8,2,6,15,36,10,0
Ben Old,NZL,"FW,MF",Saint-Étienne,Ligue 1,21,2002,5.9,7,5,3,3,1,3,11,27.3,8,8,1,7,2,9,2,0
Finn Ole Becker,GER,MF,Hoffenheim,Bundesliga,24,2000,7.4,11,5,4,6,1,1,4,25,3,7,3,4,10,21,20,0
Michael Olise,FRA,"FW,MF",Bayern Munich,Bundesliga,22,2001,25.9,36,23,10,21,5,17,38,44.7,21,23,1,22,8,44,16,2
Brian Oliván,ESP,DF,Espanyol,La Liga,30,1994,11.3,13,10,7,6,0,4,13,30.8,9,6,2,4,10,23,23,0
Lucas Oliveira Rosa,BRA,DF,Valladolid,La Liga,24,2000,21,53,33,40,11,2,35,51,68.6,16,24,9,15,28,81,69,2
Mathías Olivera,URU,DF,Napoli,Serie A,26,1997,26.3,63,35,31,25,7,32,53,60.4,21,36,12,24,28,91,74,1
Dani Olmo,ESP,"MF,FW",Barcelona,La Liga,26,1998,13.5,16,11,8,5,3,4,14,28.6,10,6,3,3,3,19,11,1
Robin Olsen,SWE,GK,Aston Villa,Premier League,34,1990,2.5,1,0,1,0,0,1,1,100,0,0,0,0,0,1,2,1
Warmed Omari,COM,DF,Lyon,Ligue 1,24,2000,0.1,0,0,0,0,0,0,0,,0,0,0,0,0,0,1,0
Becir Omeragic,SUI,DF,Montpellier,Ligue 1,22,2002,20,32,16,19,12,1,16,21,76.2,5,32,21,11,13,45,78,0
Jonas Omlin,SUI,GK,Gladbach,Bundesliga,30,1994,10.9,0,0,0,0,0,0,1,0,1,0,0,0,0,0,5,1
Andrew Omobamidele,IRL,DF,Strasbourg,Ligue 1,22,2002,6,7,4,4,3,0,2,5,40,3,12,8,4,8,15,41,0
Ado Onaiwu,JPN,"MF,FW",Auxerre,Ligue 1,28,1995,10.6,11,7,2,6,3,4,14,28.6,10,12,0,12,3,14,12,0
Amadou Onana,BEL,MF,Aston Villa,Premier League,22,2001,18,55,30,23,26,6,16,29,55.2,13,16,7,9,26,81,41,3
André Onana,CMR,GK,Manchester Utd,Premier League,28,1996,34,2,2,2,0,0,2,4,50,2,0,0,0,0,2,11,4
Jean Onana,CMR,MF,Genoa,Serie A,24,2000,3.4,12,6,2,10,0,5,9,55.6,4,6,1,5,4,16,8,1
Jacob Ondrejka,SWE,"MF,FW",Parma,Serie A,21,2002,4.7,12,6,5,7,0,10,12,83.3,2,2,0,2,7,19,2,0
Karim Onisiwo,AUT,"MF,FW",Mainz 05,Bundesliga,32,1992,1.2,1,1,0,0,1,0,0,,0,0,0,0,0,1,0,0
Paul Onuachu,NGA,FW,Southampton,Premier League,30,1994,11.7,7,2,1,5,1,3,7,42.9,4,7,2,5,1,8,16,1
Frank Onyeka,NGA,MF,Brentford,Premier League,26,1998,0.3,0,0,0,0,0,0,0,,0,0,0,0,0,0,0,0
Frank Onyeka,NGA,MF,Augsburg,Bundesliga,26,1998,28.7,58,45,22,28,8,22,40,55,18,36,9,27,36,94,36,2
Loïs Openda,BEL,"FW,MF",RB Leipzig,Bundesliga,24,2000,27.3,9,4,3,4,2,3,11,27.3,8,19,1,18,5,14,12,0
Christopher Operi,CIV,"DF,FW",Le Havre,Ligue 1,27,1997,13,13,9,6,2,5,7,12,58.3,5,20,6,14,14,27,30,0
Fredrik Oppegard,NOR,DF,Auxerre,Ligue 1,21,2002,3,6,4,4,1,1,3,7,42.9,4,2,1,1,2,8,12,1
Victor Orakpo,NGA,FW,Nice,Ligue 1,18,2006,0.4,0,0,0,0,0,0,0,,0,0,0,0,0,0,0,0
Ike Orazi,IRL,MF,Reims,Ligue 1,17,2007,0,0,0,0,0,0,0,0,,0,0,0,0,0,0,0,0
Gift Orban,NGA,"FW,DF",Lyon,Ligue 1,22,2002,2.1,0,0,0,0,0,0,1,0,1,0,0,0,0,0,0,0
Gift Orban,NGA,FW,Hoffenheim,Bundesliga,22,2002,7.6,3,1,2,1,0,1,6,16.7,5,7,0,7,0,3,3,0
Willi Orban,HUN,DF,RB Leipzig,Bundesliga,31,1992,24.7,38,21,23,14,1,23,32,71.9,9,45,31,14,21,59,169,4
Ivan Ordets,UKR,DF,Bochum,Bundesliga,32,1992,20.7,18,8,13,5,0,10,13,76.9,3,29,16,13,41,59,139,3
Lewis Orford,ENG,MF,West Ham,Premier League,18,2006,0.5,0,0,0,0,0,0,0,,0,1,0,1,1,1,0,0
Gaetano Oristanio,ITA,"FW,MF",Venezia,Serie A,21,2002,25.7,17,13,5,8,4,7,15,46.7,8,16,0,16,6,23,6,1
Aimar Oroz,ESP,MF,Osasuna,La Liga,22,2001,33,35,19,16,13,6,14,46,30.4,32,29,2,27,20,55,10,0
Riccardo Orsolini,ITA,FW,Bologna,Serie A,27,1997,20.9,16,13,6,6,4,5,11,45.5,6,26,0,26,8,24,10,1
Stefan Ortega,GER,GK,Manchester City,Premier League,31,1992,12.2,0,0,0,0,0,0,1,0,1,0,0,0,0,0,11,1
Ángel Ortíz,ESP,DF,Betis,La Liga,20,2004,3.9,12,8,8,3,1,8,17,47.1,9,6,0,6,5,17,7,0
Gabriel Osei Misehouy,NED,"FW,MF",Girona,La Liga,19,2005,2.9,1,1,0,1,0,0,1,0,1,0,0,0,0,1,0,0
Gabriel Osho,NGA,DF,Auxerre,Ligue 1,25,1998,18.4,23,15,17,3,3,13,20,65,7,32,19,13,12,35,87,0
Yordan Osorio,VEN,DF,Parma,Serie A,30,1994,1.9,5,3,4,1,0,2,2,100,0,3,1,2,4,9,6,1
Patrick Osterhage,GER,MF,Freiburg,Bundesliga,24,2000,25.2,45,29,16,27,2,14,30,46.7,16,27,3,24,18,63,37,0
William Osula,DEN,FW,Newcastle Utd,Premier League,20,2003,1.5,2,0,1,0,1,0,2,0,2,0,0,0,4,6,2,0
Jibril Othman,TUN,FW,Saint-Étienne,Ligue 1,20,2004,0.1,0,0,0,0,0,0,0,,0,0,0,0,0,0,0,0
Sebastian Otoa,DEN,DF,Genoa,Serie A,20,2004,2,1,0,1,0,0,1,2,50,1,1,1,0,3,4,14,0
David Otorbi,ESP,MF,Valencia,La Liga,16,2007,0.2,0,0,0,0,0,0,0,,0,1,0,1,0,0,0,0
Dango Ouattara,BFA,FW,Bournemouth,Premier League,22,2002,22.3,35,26,14,11,10,17,41,41.5,24,36,10,26,11,46,51,0
Guimissongui Ouattara,FRA,"DF,FW",Strasbourg,Ligue 1,18,2005,5.2,6,4,3,1,2,3,5,60,2,10,0,10,9,15,12,2
Kassoum Ouattara,FRA,"DF,FW",Monaco,Ligue 1,19,2004,4.3,9,7,5,4,0,4,14,28.6,10,6,0,6,5,14,2,1
Remi Oudin,FRA,"MF,FW",Lecce,Serie A,27,1996,3.3,3,1,1,1,1,2,4,50,2,6,2,4,2,5,1,0
Assan Ouedraogo,GER,MF,RB Leipzig,Bundesliga,18,2006,0.6,0,0,0,0,0,0,0,,0,1,0,1,0,0,0,0
Zinédine Ould Khaled,FRA,MF,Angers,Ligue 1,24,2000,3.8,9,7,5,3,1,2,13,15.4,11,6,1,5,2,11,12,0
Cheick Oumar Conde,GUI,MF,Venezia,Serie A,24,2000,1.7,6,5,3,2,1,2,5,40,3,7,2,5,4,10,3,0
Jesús Owono,EQG,GK,Alavés,La Liga,23,2001,5.4,1,1,1,0,0,1,1,100,0,0,0,0,0,1,2,0
Beres Owusu,FRA,DF,Saint-Étienne,Ligue 1,20,2003,1,2,2,1,1,0,2,2,100,0,2,2,0,0,2,5,0
Elisha Owusu,GHA,MF,Auxerre,Ligue 1,26,1997,26,73,41,29,39,5,31,48,64.6,17,33,9,24,42,115,35,1
Mikel Oyarzabal,ESP,FW,Real Sociedad,La Liga,27,1997,25,25,16,9,10,6,10,23,43.5,13,17,1,16,4,29,15,0
Daniel Oyegoke,ENG,DF,Hellas Verona,Serie A,21,2003,1.1,2,2,1,0,1,1,1,100,0,1,0,1,1,3,7,0
Salih Özcan,TUR,MF,Wolfsburg,Bundesliga,26,1998,3.9,2,2,1,0,1,1,5,20,4,5,1,4,7,9,5,0
Salih Özcan,TUR,MF,Dortmund,Bundesliga,26,1998,4.3,11,7,6,4,1,7,13,53.8,6,7,0,7,11,22,10,0
Cenk Özkacar,TUR,DF,Valladolid,La Liga,23,2000,8.4,9,5,7,2,0,4,14,28.6,10,9,6,3,18,27,69,1
Nico O’Reilly,ENG,DF,Manchester City,Premier League,19,2005,5.9,9,4,3,3,3,4,8,50,4,5,1,4,4,13,12,0
Jon Pacheco,ESP,DF,Real Sociedad,La Liga,23,2001,9.5,15,9,12,3,0,10,12,83.3,2,8,6,2,9,24,49,2
Willian Pacho,ECU,DF,Paris S-G,Ligue 1,22,2001,23.7,56,32,34,22,0,23,32,71.9,9,35,22,13,40,96,91,1
Daniele Padelli,ITA,GK,Udinese,Serie A,38,1985,1,0,0,0,0,0,0,1,0,1,0,0,0,0,0,0,0
Alex Padilla,ESP,GK,Athletic Club,La Liga,20,2003,3.6,0,0,0,0,0,0,0,,0,0,0,0,0,0,2,1
Simone Pafundi,ITA,"MF,DF",Udinese,Serie A,18,2006,1.3,3,3,2,0,1,1,4,25,3,0,0,0,0,3,1,0
Exequiel Palacios,ARG,MF,Leverkusen,Bundesliga,25,1998,12.8,22,15,8,10,4,10,18,55.6,8,14,1,13,13,35,15,1
Tomás Palacios,ARG,DF,Monza,Serie A,21,2003,5,11,5,9,2,0,9,13,69.2,4,7,2,5,8,19,17,2
Tomás Palacios,ARG,DF,Inter,Serie A,21,2003,0.1,0,0,0,0,0,0,0,,0,0,0,0,1,1,0,0
Isaac Palazón Camacho,ESP,"MF,FW",Rayo Vallecano,La Liga,29,1994,24,22,17,10,6,6,8,34,23.5,26,22,3,19,8,30,13,1
Alberto Paleari,ITA,GK,Torino,Serie A,31,1992,1,0,0,0,0,0,0,0,,0,0,0,0,0,0,2,0
Marco Palestra,ITA,DF,Atalanta,Serie A,19,2005,2.5,6,4,3,2,1,3,3,100,0,4,1,3,2,8,4,0
João Palhinha,POR,MF,Bayern Munich,Bundesliga,29,1995,7.5,20,14,6,11,3,11,16,68.8,5,13,1,12,4,24,9,1
Nicolas Pallois,FRA,DF,Nantes,Ligue 1,36,1987,22.4,61,27,44,13,4,37,63,58.7,26,48,18,30,28,89,164,3
Matteo Palma,GER,DF,Udinese,Serie A,16,2008,0.1,0,0,0,0,0,0,0,,0,1,1,0,0,0,1,0
Alex Palmer,ENG,GK,Ipswich Town,Premier League,27,1996,13,0,0,0,0,0,0,0,,0,0,0,0,0,0,12,0
Cole Palmer,ENG,"MF,FW",Chelsea,Premier League,22,2002,35.5,34,20,12,10,12,12,27,44.4,15,16,1,15,11,45,20,1
Emerson Palmieri,ITA,DF,West Ham,Premier League,29,1994,23.5,60,31,37,18,5,27,48,56.3,21,32,8,24,21,81,59,0
Mats Pannewig,GER,MF,Bochum,Bundesliga,19,2004,3,10,6,7,3,0,3,12,25,9,8,1,7,2,12,8,0
Lucas Paquetá,BRA,"MF,FW",West Ham,Premier League,26,1997,26.4,66,37,25,30,11,27,55,49.1,28,29,4,25,18,84,37,6
Aitor Paredes,ESP,DF,Athletic Club,La Liga,24,2000,20.1,15,13,10,5,0,8,15,53.3,7,26,15,11,22,37,114,4
Kevin Paredes,USA,DF,Wolfsburg,Bundesliga,21,2003,1.4,3,1,3,0,0,2,3,66.7,1,2,2,0,1,4,0,0
Leandro Paredes,ARG,MF,Roma,Serie A,30,1994,15.3,26,14,9,12,5,16,32,50,16,14,5,9,19,45,33,2
Daniel Parejo,ESP,MF,Villarreal,La Liga,35,1989,25.3,52,40,27,20,5,29,54,53.7,25,24,7,17,24,76,40,1
Iago Parente,ESP,DF,Valladolid,La Liga,18,2006,0.8,0,0,0,0,0,0,0,,0,0,0,0,0,0,2,0
Fabiano Parisi,ITA,"DF,MF",Fiorentina,Serie A,23,2000,11.7,27,17,11,12,4,12,21,57.1,9,14,2,12,17,44,17,0
Thomas Partey,GHA,"MF,DF",Arsenal,Premier League,31,1993,31.1,89,53,26,39,24,46,76,60.5,30,29,9,20,35,124,49,4
Mario Pašalić,CRO,MF,Atalanta,Serie A,29,1995,21.9,26,16,11,13,2,11,26,42.3,15,22,7,15,12,38,28,1
Álvaro Pascual,ESP,FW,Sevilla,La Liga,22,2002,4.5,5,3,0,3,2,1,5,20,4,4,0,4,2,7,9,0
Felix Passlack,GER,"DF,MF",Bochum,Bundesliga,26,1998,25.9,53,23,32,13,8,30,55,54.5,25,42,11,31,18,71,63,1
Patric,ESP,DF,Lazio,Serie A,31,1993,6.7,9,6,6,3,0,6,10,60,4,3,2,1,3,12,22,1
Rui Patrício,POR,GK,Atalanta,Serie A,36,1988,3,0,0,0,0,0,0,0,,0,0,0,0,0,0,3,0
Nathan Patterson,SCO,DF,Everton,Premier League,22,2001,3.9,11,6,7,4,0,7,14,50,7,2,0,2,2,13,7,0
Benjamin Pavard,FRA,DF,Inter,Serie A,28,1996,17.6,29,16,12,12,5,18,25,72,7,16,12,4,16,45,52,0
Aleksandar Pavlovic,GER,MF,Bayern Munich,Bundesliga,20,2004,16.1,38,21,13,15,10,22,32,68.8,10,18,3,15,5,43,14,0
Strahinja Pavlović,SRB,DF,Milan,Serie A,23,2001,20.7,52,31,32,19,1,29,50,58,21,17,6,11,16,68,82,0
Leonardo Pavoletti,ITA,"FW,MF",Cagliari,Serie A,35,1988,4.9,1,0,0,1,0,0,0,,0,4,1,3,0,1,3,0
Martín Payero,ARG,MF,Udinese,Serie A,25,1998,15.3,24,16,4,14,6,8,16,50,8,16,2,14,13,37,13,0
Nicolas Pays,FRA,"FW,MF",Montpellier,Ligue 1,20,2003,5,13,6,3,4,6,4,8,50,4,1,0,1,4,17,2,0
Nicolás Paz,ARG,"MF,FW",Como,Serie A,19,2004,29.9,51,33,18,26,7,24,51,47.1,27,49,3,46,21,72,16,0
Mads Pedersen,DEN,DF,Augsburg,Bundesliga,27,1996,2.6,8,7,5,2,1,4,5,80,1,4,0,4,2,10,6,0
Marcus Pedersen,NOR,DF,Torino,Serie A,24,2000,15.1,13,8,6,6,1,10,16,62.5,6,11,2,9,13,26,34,1
Alfonso Pedraza,ESP,"DF,MF",Villarreal,La Liga,28,1996,5.1,3,2,2,0,1,2,4,50,2,3,1,2,6,9,16,0
Pedri,ESP,MF,Barcelona,La Liga,21,2002,32,61,34,14,38,9,24,70,34.3,46,45,3,42,26,87,21,1
Pedro,ESP,"FW,MF",Lazio,Serie A,37,1987,12.2,19,14,5,9,5,10,21,47.6,11,11,0,11,3,22,3,1
Kévin Pedro,FRA,DF,Saint-Étienne,Ligue 1,18,2006,0.1,3,0,2,1,0,3,3,100,0,1,0,1,2,5,1,0
Adrià Pedrosa,ESP,DF,Sevilla,La Liga,26,1998,25.5,56,32,34,16,6,31,54,57.4,23,43,11,32,24,80,85,0
Jordan Pefok,USA,FW,Reims,Ligue 1,28,1996,4.2,3,2,0,3,0,2,3,66.7,1,3,1,2,2,5,5,0
Jordan Pefok,USA,FW,Union Berlin,Bundesliga,28,1996,10.1,11,6,6,0,5,3,7,42.9,4,9,2,7,4,15,18,0
Pejiño,ESP,FW,Las Palmas,La Liga,28,1996,0.2,1,1,0,1,0,1,1,100,0,0,0,0,0,1,0,0
Pietro Pellegri,ITA,FW,Empoli,Serie A,23,2001,4.6,7,2,0,6,1,2,4,50,2,2,0,2,0,7,3,0
Lorenzo Pellegrini,ITA,MF,Roma,Serie A,28,1996,18.1,24,16,5,13,6,8,19,42.1,11,8,1,7,6,30,22,0
Luca Pellegrini,ITA,DF,Lazio,Serie A,25,1999,11.9,23,11,11,10,2,17,32,53.1,15,10,3,7,19,42,32,0
Mateo Pellegrino,ARG,FW,Parma,Serie A,23,2001,8.2,3,2,1,2,0,1,4,25,3,6,1,5,1,4,6,0
Théo Pellenard,FRA,DF,Auxerre,Ligue 1,30,1994,0.5,3,2,2,1,0,1,3,33.3,2,1,0,1,0,3,3,0
Andy Pelmard,FRA,DF,Lecce,Serie A,24,2000,1.4,6,6,5,1,0,4,4,100,0,1,0,1,0,6,5,0
Andy Pelmard,FRA,DF,Las Palmas,La Liga,24,2000,2.3,5,0,3,2,0,4,5,80,1,3,1,2,2,7,20,0
Timothee Pembele,FRA,DF,Le Havre,Ligue 1,21,2002,12.4,30,22,17,9,4,14,23,60.9,9,16,5,11,11,41,42,0
Faris Pemi Moumbagna,CMR,FW,Marseille,Ligue 1,24,2000,0.1,0,0,0,0,0,0,0,,0,0,0,0,0,0,0,0
Iñaki Peña,ESP,GK,Barcelona,La Liga,25,1999,15.5,0,0,0,0,0,0,2,0,2,0,0,0,0,0,20,1
Rubén Peña,ESP,"FW,DF",Osasuna,La Liga,33,1991,8.6,12,5,4,3,5,5,24,20.8,19,11,0,11,6,18,12,0
Nicolas Pépé,CIV,"FW,MF",Villarreal,La Liga,29,1995,16.7,22,9,12,6,4,6,17,35.3,11,12,1,11,5,27,12,0
Peque,ESP,"MF,FW",Sevilla,La Liga,21,2002,12.6,16,5,4,10,2,7,17,41.2,10,16,0,16,8,24,5,0
Sergiu Perciun,MDA,"FW,MF",Torino,Serie A,18,2006,1.7,2,2,0,0,2,1,4,25,3,2,0,2,1,3,2,0
Óscar Perea,COL,"MF,DF",Strasbourg,Ligue 1,18,2005,0.2,0,0,0,0,0,0,0,,0,0,0,0,0,0,0,0
Andreas Pereira,BRA,MF,Fulham,Premier League,28,1996,22.4,24,13,8,11,5,10,42,23.8,32,17,2,15,8,32,17,3
Mathias Pereira Lage,POR,"FW,MF",Brest,Ligue 1,27,1996,17.5,37,24,16,13,8,18,39,46.2,21,17,2,15,20,57,20,2
Pedro Pereira,POR,DF,Monza,Serie A,26,1998,29.6,53,32,30,18,5,35,55,63.6,20,26,12,14,21,74,85,5
Ricardo Pereira,POR,DF,Leicester City,Premier League,30,1993,4.3,13,8,4,6,3,7,14,50,7,8,3,5,4,17,11,0
Gastón Pereiro,URU,MF,Genoa,Serie A,29,1995,0.3,1,0,0,1,0,1,1,100,0,0,0,0,0,1,1,0
Daniel Peretz,ISR,GK,Bayern Munich,Bundesliga,24,2000,3,0,0,0,0,0,0,1,0,1,0,0,0,0,0,2,0
Ayoze Pérez,ESP,FW,Villarreal,La Liga,31,1993,21.9,27,14,5,18,4,6,24,25,18,17,0,17,8,35,15,0
Carles Pérez,ESP,"MF,FW",Getafe,La Liga,26,1998,15.9,33,23,11,14,8,21,48,43.8,27,19,2,17,6,39,22,0
Francisco Perez,ESP,"FW,MF",Valencia,La Liga,21,2002,6.3,17,12,7,8,2,10,16,62.5,6,8,1,7,3,20,6,0
Kike Pérez,ESP,MF,Venezia,Serie A,27,1997,12.4,41,25,18,12,11,18,44,40.9,26,14,2,12,10,51,15,0
Kike Pérez,ESP,MF,Valladolid,La Liga,27,1997,13.2,37,26,15,19,3,15,26,57.7,11,16,4,12,7,44,18,0
Luis Pérez,ESP,DF,Valladolid,La Liga,29,1995,28.4,41,30,25,11,5,24,40,60,16,26,9,17,29,70,86,0
Nehuén Pérez,ARG,DF,Udinese,Serie A,24,2000,2,1,1,0,0,1,0,1,0,1,2,2,0,1,2,7,0
Simone Perilli,ITA,GK,Hellas Verona,Serie A,29,1995,2,0,0,0,0,0,0,0,,0,0,0,0,0,0,1,0
Mattia Perin,ITA,GK,Juventus,Serie A,31,1992,5,0,0,0,0,0,0,0,,0,0,0,0,0,0,2,0
Romain Perraud,FRA,DF,Betis,La Liga,26,1997,22.2,36,22,15,16,5,21,46,45.7,25,18,4,14,22,58,71,1
Lucas Perri,BRA,GK,Lyon,Ligue 1,26,1997,33,1,1,1,0,0,0,4,0,4,1,0,1,0,1,22,1
Gaëtan Perrin,FRA,"MF,FW",Auxerre,Ligue 1,28,1996,29.9,49,26,22,12,15,21,48,43.8,27,10,0,10,12,61,4,1
Máximo Perrone,ARG,MF,Como,Serie A,21,2003,20.6,38,27,19,14,5,13,38,34.2,25,15,2,13,20,58,43,0
Noah Pesch,CRO,FW,Gladbach,Bundesliga,19,2005,0.1,1,0,0,0,1,0,0,,0,0,0,0,0,1,0,0
Matteo Pessina,ITA,MF,Monza,Serie A,27,1997,9.5,15,4,3,11,1,9,14,64.3,5,6,0,6,12,27,7,0
Andrea Petagna,ITA,FW,Monza,Serie A,29,1995,3.7,2,1,0,1,1,1,2,50,1,0,0,0,1,3,2,0
Prosper Peter,NGA,"MF,FW",Angers,Ligue 1,16,2007,0.3,2,1,0,2,0,0,0,,0,0,0,0,0,2,0,0
Léo Pétrot,FRA,DF,Saint-Étienne,Ligue 1,27,1997,29.3,62,39,38,19,5,34,51,66.7,17,50,27,23,42,104,103,1
Đorđe Petrović,SRB,GK,Strasbourg,Ligue 1,24,1999,31,1,1,1,0,0,0,0,,0,0,0,0,0,1,24,1
Giuseppe Pezzella,ITA,"DF,FW",Empoli,Serie A,26,1997,32,55,31,28,17,10,29,57,50.9,28,32,8,24,15,70,110,2
Valentín Pezzolesi,ESP,DF,Las Palmas,La Liga,17,2007,0.1,0,0,0,0,0,0,0,,0,0,0,0,0,0,1,1
Luca Philipp,GER,GK,Hoffenheim,Bundesliga,23,2000,6,1,0,1,0,0,1,1,100,0,0,0,0,0,1,1,0
Maximilian Philipp,GER,"MF,FW",Freiburg,Bundesliga,30,1994,0.2,0,0,0,0,0,0,0,,0,0,0,0,0,0,0,0
Kalvin Phillips,ENG,MF,Ipswich Town,Premier League,28,1995,13.7,35,19,8,20,7,15,39,38.5,24,35,6,29,19,54,37,2
Jaden Philogene Bidace,ENG,"FW,MF",Aston Villa,Premier League,22,2002,3.7,11,5,4,7,0,4,6,66.7,2,5,0,5,3,14,2,1
Jaden Philogene Bidace,ENG,"FW,DF",Ipswich Town,Premier League,22,2002,5.3,14,7,6,6,2,8,15,53.3,7,11,1,10,10,24,9,1
Pica,ESP,DF,Alavés,La Liga,22,2002,5.5,9,7,7,2,0,4,9,44.4,5,7,6,1,9,18,26,0
Roberto Piccoli,ITA,FW,Cagliari,Serie A,23,2001,34.7,13,9,2,6,5,3,12,25,9,12,4,8,3,16,31,0
Benedikt Pichler,AUT,FW,Holstein Kiel,Bundesliga,27,1997,8.7,5,2,1,0,4,2,4,50,2,4,2,2,2,7,11,0
Jordan Pickford,ENG,GK,Everton,Premier League,30,1994,38,1,0,1,0,0,1,2,50,1,0,0,0,1,2,30,2
Amos Pieper,GER,DF,Werder Bremen,Bundesliga,26,1998,16.6,32,17,16,11,5,21,33,63.6,12,28,17,11,24,56,98,1
Marvin Pieringer,GER,"FW,MF",Heidenheim,Bundesliga,24,1999,24.5,23,13,5,12,6,5,10,50,5,21,2,19,8,31,32,0
Nicholas Pierini,ITA,MF,Venezia,Serie A,25,1998,0.9,0,0,0,0,0,0,1,0,1,2,0,2,0,0,0,0
Santiago Pierotti,ARG,FW,Lecce,Serie A,23,2001,21.5,46,24,22,18,6,23,51,45.1,28,31,5,26,14,60,32,0
Balthazar Pierret,FRA,MF,Lecce,Serie A,24,2000,19.1,51,31,25,23,3,13,30,43.3,17,19,5,14,19,70,31,1
Andrea Pinamonti,ITA,FW,Genoa,Serie A,25,1999,31.7,10,6,0,7,3,2,8,25,6,16,4,12,1,11,28,2
Ethan Pinnock,JAM,DF,Brentford,Premier League,31,1993,21.3,35,19,15,16,4,13,24,54.2,11,29,18,11,24,59,142,4
Yeremi Pino,ESP,"MF,FW",Villarreal,La Liga,21,2002,21.5,60,32,20,32,8,32,65,49.2,33,38,3,35,8,68,18,0
Nicola Pintus,ITA,DF,Cagliari,Serie A,19,2005,0,0,0,0,0,0,0,0,,0,0,0,0,0,0,2,0
Niccolò Pisilli,ITA,MF,Roma,Serie A,19,2004,13.6,24,11,11,8,5,12,22,54.5,10,14,3,11,11,35,16,0
Damián Pizarro,CHI,"FW,MF",Udinese,Serie A,19,2005,0.2,0,0,0,0,0,0,0,,0,0,0,0,0,0,0,0
Semuel Pizzignacco,ITA,GK,Monza,Serie A,22,2001,8.2,0,0,0,0,0,0,1,0,1,0,0,0,0,0,6,0
Alassane Pléa,FRA,"MF,FW",Gladbach,Bundesliga,31,1993,21.1,7,3,0,2,5,4,13,30.8,9,11,0,11,2,9,7,1
Tommaso Pobega,ITA,MF,Bologna,Serie A,25,1999,13.1,33,19,12,15,6,22,30,73.3,8,16,4,12,14,47,16,0
Daniel Podence,POR,"MF,FW",Wolves,Premier League,28,1995,0.5,0,0,0,0,0,0,1,0,1,0,0,0,0,0,0,0
Joel Pohjanpalo,FIN,FW,Venezia,Serie A,29,1994,17.8,3,3,1,2,0,0,4,0,4,7,4,3,4,7,24,0
Matteo Politano,ITA,"FW,MF",Napoli,Serie A,30,1993,31.2,29,15,17,11,1,15,43,34.9,28,21,1,20,13,42,50,1
Alfie Pond,ENG,DF,Wolves,Premier League,20,2004,0,0,0,0,0,0,0,0,,0,0,0,0,0,0,0,0
Marin Pongračić,CRO,DF,Fiorentina,Serie A,26,1997,14.4,18,13,13,4,1,7,11,63.6,4,14,6,8,12,30,69,2
Nick Pope,ENG,GK,Newcastle Utd,Premier League,32,1992,28,0,0,0,0,0,0,0,,0,1,0,1,1,1,32,5
Finn Porath,GER,"DF,MF",Holstein Kiel,Bundesliga,27,1997,21.9,45,26,24,14,7,26,53,49.1,27,27,9,18,21,66,67,0
Pedro Porro,ESP,DF,Tottenham,Premier League,24,1999,29,66,49,34,22,10,44,77,57.1,33,44,17,27,36,102,84,2
Portu,ESP,"FW,MF",Girona,La Liga,32,1992,8.7,13,7,5,5,3,7,10,70,3,8,0,8,0,13,2,0
Stefan Posch,AUT,DF,Bologna,Serie A,27,1997,7.9,26,15,12,9,5,15,25,60,10,19,4,15,5,31,22,0
Stefan Posch,AUT,DF,Atalanta,Serie A,27,1997,4.3,18,11,7,8,3,8,9,88.9,1,5,1,4,4,22,13,0
Tom Pouilly,FRA,"DF,MF",Lens,Ligue 1,21,2003,3,9,6,5,1,3,5,10,50,5,5,1,4,4,13,11,0
Yussuf Poulsen,DEN,"FW,MF",RB Leipzig,Bundesliga,30,1994,4.2,10,5,2,6,2,4,8,50,4,7,2,5,0,10,14,0
Beñat Prados,ESP,MF,Athletic Club,La Liga,23,2001,19.1,55,36,20,27,8,25,53,47.2,28,21,2,19,28,83,26,0
Alexander Prass,AUT,DF,Hoffenheim,Bundesliga,23,2001,17.4,42,23,24,15,3,24,59,40.7,35,33,6,27,9,51,53,4
Matteo Prati,ITA,MF,Cagliari,Serie A,20,2003,6.3,10,4,2,7,1,3,11,27.3,8,5,2,3,7,17,10,1
Abdón Prats,ESP,"FW,MF",Mallorca,La Liga,31,1992,5.1,2,1,1,1,0,1,2,50,1,2,1,1,1,3,5,0
David Preu,GER,"MF,DF",Union Berlin,Bundesliga,19,2004,1.3,1,1,0,1,0,0,2,0,2,4,2,2,0,1,2,0
Grischa Prömel,GER,MF,Hoffenheim,Bundesliga,29,1995,1.9,0,0,0,0,0,0,1,0,1,1,1,0,2,2,4,0
Ivan Provedel,ITA,GK,Lazio,Serie A,30,1994,29,0,0,0,0,0,0,0,,0,1,0,1,1,1,12,3
Ivan Prtajin,CRO,FW,Union Berlin,Bundesliga,28,1996,1.8,3,2,0,1,2,0,0,,0,2,0,2,0,3,3,0
Javi Puado,ESP,"FW,MF",Espanyol,La Liga,26,1998,33,22,17,14,4,4,8,20,40,12,18,3,15,5,27,19,0
Tymoteusz Puchacz,POL,DF,Holstein Kiel,Bundesliga,25,1999,4.4,9,4,6,3,0,5,7,71.4,2,4,1,3,3,12,11,0
Diego Pugno,ITA,FW,Juventus,Serie A,18,2006,0.1,0,0,0,0,0,0,0,,0,0,0,0,0,0,0,0
Christian Pulisic,USA,"FW,MF",Milan,Serie A,25,1998,27.5,43,29,17,14,12,15,37,40.5,22,24,2,22,5,48,13,2
Jarell Quansah,ENG,DF,Liverpool,Premier League,21,2003,5.5,12,8,8,4,0,7,10,70,3,10,7,3,7,19,28,1
Leopold Querfeld,AUT,DF,Union Berlin,Bundesliga,20,2003,19.4,25,12,21,4,0,13,18,72.2,5,25,10,15,19,44,144,2
Dani Raba,ESP,"FW,MF",Leganés,La Liga,28,1995,20.9,37,23,17,15,5,17,42,40.5,25,27,3,24,14,51,19,1
Adrien Rabiot,FRA,MF,Marseille,Ligue 1,29,1995,27.6,49,31,17,21,11,19,32,59.4,13,21,2,19,21,70,32,0
Ionuț Radu,ROU,GK,Venezia,Serie A,27,1997,15,0,0,0,0,0,0,0,,0,0,0,0,0,0,9,0
Hamza Rafia,TUN,MF,Lecce,Serie A,25,1999,11.8,44,27,14,25,5,15,32,46.9,17,7,2,5,4,48,18,1
Hákon Rafn Valdimarsson,ISL,GK,Brentford,Premier League,22,2001,1.6,0,0,0,0,0,0,0,,0,0,0,0,0,0,2,0
Arnau Rafús,ESP,GK,Valladolid,La Liga,21,2003,1,0,0,0,0,0,0,0,,0,0,0,0,0,0,0,1
Antonio Raillo,ESP,DF,Mallorca,La Liga,32,1991,35.6,31,18,18,10,3,14,20,70,6,51,38,13,29,60,222,1
Antonio Raimondo,ITA,"FW,DF",Venezia,Serie A,20,2004,1,2,1,1,1,0,0,0,,0,0,0,0,0,2,0,1
Ylber Ramadani,ALB,MF,Lecce,Serie A,28,1996,20.1,51,28,24,27,0,33,52,63.5,19,26,9,17,24,75,26,3
Benito Ramírez,ESP,"DF,FW",Las Palmas,La Liga,29,1995,5.3,10,5,4,6,0,9,16,56.3,7,8,3,5,1,11,14,1
Sandro Ramírez,ESP,"FW,MF",Las Palmas,La Liga,29,1995,22.6,27,15,10,13,4,13,30,43.3,17,20,0,20,16,43,22,2
Jacobo Ramón,ESP,DF,Real Madrid,La Liga,19,2005,2.3,7,3,4,3,0,2,2,100,0,1,0,1,3,10,8,2
Gonçalo Ramos,POR,FW,Paris S-G,Ligue 1,23,2001,11.8,11,6,5,5,1,3,6,50,3,5,1,4,0,11,5,0
Aaron Ramsdale,ENG,GK,Southampton,Premier League,26,1998,30,0,0,0,0,0,0,3,0,3,0,0,0,2,2,10,3
Jacob Ramsey,ENG,"FW,MF",Aston Villa,Premier League,23,2001,18,30,15,14,10,6,10,20,50,10,23,4,19,8,38,8,1
Luca Ranieri,ITA,DF,Fiorentina,Serie A,25,1999,33.1,42,24,28,12,2,20,25,80,5,47,32,15,27,69,154,1
Grant Ranos,ARM,FW,Gladbach,Bundesliga,21,2003,0.2,1,0,0,1,0,0,1,0,1,2,0,2,0,1,0,0
Lilian Raolisoa,FRA,"DF,FW",Angers,Ligue 1,24,2000,14.6,41,24,24,13,4,17,38,44.7,21,11,2,9,15,56,45,0
Raphinha,BRA,"FW,MF",Barcelona,La Liga,27,1996,31.5,36,22,6,19,11,19,39,48.7,20,29,2,27,11,47,26,0
Marcus Rashford,ENG,"FW,MF",Manchester Utd,Premier League,26,1997,10.9,7,4,2,2,3,3,9,33.3,6,8,0,8,4,11,7,0
Marcus Rashford,ENG,FW,Aston Villa,Premier League,26,1997,4.9,10,7,2,3,5,4,6,66.7,2,2,0,2,1,11,3,0
Giacomo Raspadori,ITA,"FW,MF",Napoli,Serie A,24,2000,12.3,18,9,6,10,2,8,12,66.7,4,10,2,8,3,21,13,0
Andrei Ratiu,ROU,DF,Rayo Vallecano,La Liga,26,1998,34.1,71,41,40,21,10,42,70,60,28,45,5,40,27,98,73,2
Raúl,ESP,"FW,MF",Osasuna,La Liga,23,2000,8.3,13,8,3,6,4,5,10,50,5,4,0,4,0,13,6,0
David Raum,GER,DF,RB Leipzig,Bundesliga,26,1998,19.8,38,28,16,14,8,20,35,57.1,15,25,8,17,9,47,47,4
Federico Ravaglia,ITA,GK,Bologna,Serie A,24,1999,11.7,0,0,0,0,0,0,0,,0,0,0,0,0,0,9,0
Rayan Raveloson,MAD,"MF,DF",Auxerre,Ligue 1,27,1997,8,6,5,2,4,0,5,15,33.3,10,8,7,1,5,11,22,0
David Raya,ESP,GK,Arsenal,Premier League,28,1995,38,0,0,0,0,0,0,2,0,2,0,0,0,2,2,21,9
Abderrahman Rebbach,ALG,"FW,MF",Alavés,La Liga,25,1998,4.3,3,2,3,0,0,0,6,0,6,4,0,4,0,3,6,0
Ante Rebić,CRO,"FW,MF",Lecce,Serie A,30,1993,8.8,12,9,5,5,2,3,9,33.3,6,7,1,6,2,14,4,1
Harrison Reed,ENG,MF,Fulham,Premier League,29,1995,1.2,6,3,3,2,1,1,3,33.3,2,1,0,1,1,7,3,0
Remy Rees-Dottin,ENG,FW,Bournemouth,Premier League,18,2006,0,0,0,0,0,0,0,0,,0,0,0,0,0,0,0,0
Sergio Reguilón,ESP,DF,Tottenham,Premier League,27,1996,2.2,4,3,1,3,0,2,5,40,3,7,0,7,4,8,8,0
Tijjani Reijnders,NED,MF,Milan,Serie A,26,1998,34.8,26,13,6,14,6,10,26,38.5,16,22,4,18,38,64,28,2
Pepe Reina,ESP,GK,Como,Serie A,41,1982,11.5,0,0,0,0,0,0,1,0,1,0,0,0,0,0,3,2
Vitor Reis,BRA,DF,Manchester City,Premier League,18,2006,0,0,0,0,0,0,0,0,,0,0,0,0,0,0,1,0
Rocco Reitz,GER,MF,Gladbach,Bundesliga,22,2002,20.3,52,24,24,24,4,24,43,55.8,19,39,16,23,53,105,59,2
Nicolai Remberg,GER,MF,Holstein Kiel,Bundesliga,24,2000,26.9,45,25,24,17,4,19,41,46.3,22,46,20,26,29,74,100,0
Álex Remiro,ESP,GK,Real Sociedad,La Liga,29,1995,36,1,0,1,0,0,1,2,50,1,0,0,0,0,1,18,4
Devyne Rensch,NED,DF,Roma,Serie A,21,2003,5.2,17,13,8,8,1,9,10,90,1,5,3,2,7,24,12,1
Daniel Requena,ESP,MF,Villarreal,La Liga,20,2004,0.1,0,0,0,0,0,0,0,,0,0,0,0,0,0,0,0
Guillaume Restes,FRA,GK,Toulouse,Ligue 1,19,2005,28.3,2,1,2,0,0,2,3,66.7,1,0,0,0,1,3,16,1
Mateo Retegui,ITA,FW,Atalanta,Serie A,25,1999,26.5,14,9,0,9,5,3,16,18.8,13,7,0,7,4,18,17,0
Elvis Rexhbeçaj,KVX,MF,Augsburg,Bundesliga,26,1997,19.8,27,19,9,14,4,15,35,42.9,20,40,9,31,16,43,22,1
Gio Reyna,USA,MF,Dortmund,Bundesliga,21,2002,3.9,7,0,3,0,4,4,5,80,1,3,1,2,0,7,9,0
Chadi Riad,MAR,DF,Crystal Palace,Premier League,21,2003,1,5,2,2,2,1,2,3,66.7,1,0,0,0,2,7,0,0
Alexsandro Ribeiro,BRA,DF,Lille,Ligue 1,24,1999,30,32,19,18,13,1,20,30,66.7,10,23,13,10,27,59,143,3
Samuele Ricci,ITA,MF,Torino,Serie A,22,2001,31.4,35,21,15,14,6,18,28,64.3,10,23,9,14,25,60,51,2
Declan Rice,ENG,MF,Arsenal,Premier League,25,1999,31.4,53,25,22,25,6,17,41,41.5,24,27,13,14,25,78,51,0
Chris Richards,USA,DF,Crystal Palace,Premier League,24,2000,21.4,47,30,24,17,6,24,41,58.5,17,40,14,26,19,66,121,0
Amir Richardson,MAR,MF,Fiorentina,Serie A,22,2002,11.4,30,13,13,15,2,9,21,42.9,12,14,1,13,6,36,29,1
Richarlison,BRA,FW,Tottenham,Premier League,27,1997,5.6,5,3,0,4,1,0,3,0,3,1,1,0,0,5,8,0
Diego Rico,ESP,DF,Getafe,La Liga,31,1993,31.3,81,49,47,29,5,47,85,55.3,38,41,3,38,34,115,102,2
Fabian Rieder,SUI,"MF,FW",Stuttgart,Bundesliga,22,2002,9.6,17,14,4,9,4,7,23,30.4,16,10,1,9,10,27,7,1
Lasse Rieß,GER,GK,Mainz 05,Bundesliga,23,2001,2,0,0,0,0,0,0,0,,0,0,0,0,0,0,5,0
Luis Rioja,ESP,FW,Alavés,La Liga,30,1993,0.3,2,1,0,1,1,1,2,50,1,2,0,2,0,2,0,0
Luis Rioja,ESP,"MF,FW",Valencia,La Liga,30,1993,31.5,33,21,14,12,7,14,42,33.3,28,30,1,29,22,55,44,1
Rodrigo Riquelme,ESP,"MF,DF",Atlético Madrid,La Liga,24,2000,5.7,11,5,4,6,1,6,11,54.5,5,3,0,3,2,13,3,0
Alberto Risco,ESP,"MF,FW",Getafe,La Liga,18,2005,0.8,4,4,2,0,2,1,6,16.7,5,2,0,2,0,4,0,0
Mihailo Ristić,SRB,"DF,MF",Celta Vigo,La Liga,28,1995,4.8,7,7,4,2,1,4,6,66.7,2,1,0,1,2,9,18,0
Lars Ritzka,GER,"DF,MF",St. Pauli,Bundesliga,26,1998,10.2,49,29,28,16,5,25,41,61,16,16,2,14,11,60,41,0
Gorka Rivera Alonso,ESP,"DF,MF",Getafe,La Liga,19,2004,0.2,2,0,0,2,0,2,2,100,0,0,0,0,0,2,0,0
Sergi Roberto,ESP,MF,Como,Serie A,32,1992,7.7,14,8,5,5,4,5,7,71.4,2,7,1,6,9,23,14,0
Andrew Robertson,SCO,DF,Liverpool,Premier League,30,1994,27.6,39,22,25,10,4,31,51,60.8,20,10,4,6,21,60,54,2
Antonee Robinson,USA,DF,Fulham,Premier League,26,1997,35.2,95,61,57,31,7,45,95,47.4,50,43,9,34,62,157,133,2
Jay Robinson,ENG,"MF,FW",Southampton,Premier League,17,2007,1.5,4,1,3,0,1,1,1,100,0,0,0,0,0,4,1,0
Marc Roca,ESP,MF,Betis,La Liga,27,1996,10.1,20,14,10,9,1,9,17,52.9,8,17,5,12,14,34,14,2
Rodri,ESP,MF,Manchester City,Premier League,28,1996,0.8,2,1,1,1,0,0,0,,0,1,0,1,1,3,1,0
Rodri,ESP,FW,Betis,La Liga,24,2000,1.3,2,1,1,1,0,1,2,50,1,2,1,1,1,3,1,1
Adrian Rodriguez,ESP,GK,Alavés,La Liga,23,2000,1.4,0,0,0,0,0,0,1,0,1,0,0,0,0,0,3,1
Alejandro Rodriguez,POR,MF,Lyon,Ligue 1,16,2008,0.2,0,0,0,0,0,0,0,,0,0,0,0,0,0,0,0
Álvaro Rodríguez,URU,FW,Getafe,La Liga,20,2004,9.5,10,7,0,7,3,5,10,50,5,23,0,23,3,13,12,0
Óscar Rodríguez Arnaiz,ESP,"MF,FW",Leganés,La Liga,26,1998,14.8,32,17,10,16,6,14,32,43.8,18,10,1,9,20,52,20,0
Arturo Rodríguez,ESP,FW,Las Palmas,La Liga,17,2006,0.2,0,0,0,0,0,0,0,,0,0,0,0,0,0,0,0
Damián Rodríguez,ESP,MF,Celta Vigo,La Liga,21,2003,10.3,14,9,3,10,1,6,16,37.5,10,6,1,5,7,21,13,0
Dani Rodríguez,ESP,"MF,FW",Mallorca,La Liga,36,1988,24,49,29,18,21,10,14,27,51.9,13,22,3,19,12,61,30,0
Daniel Rodriguez,ESP,FW,Barcelona,La Liga,18,2005,0.4,0,0,0,0,0,0,0,,0,1,0,1,0,0,0,0
Guido Rodríguez,ARG,MF,West Ham,Premier League,30,1994,12.8,36,19,21,15,0,17,33,51.5,16,23,9,14,13,49,35,1
James Rodríguez,COL,"MF,FW",Rayo Vallecano,La Liga,33,1991,1.6,3,2,1,2,0,0,2,0,2,2,0,2,1,4,0,0
Javi Rodríguez,ESP,DF,Celta Vigo,La Liga,21,2003,27.9,53,38,35,17,1,33,47,70.2,14,29,10,19,33,86,96,2
Jesus Rodríguez,ESP,FW,Betis,La Liga,18,2005,12.3,16,14,6,6,4,5,18,27.8,13,16,0,16,6,22,3,0
Kirian Rodríguez,ESP,MF,Las Palmas,La Liga,28,1996,19.5,33,17,12,18,3,22,43,51.2,21,22,4,18,10,43,21,0
Ricardo Rodríguez,SUI,DF,Betis,La Liga,31,1992,14.2,28,15,16,5,7,17,26,65.4,9,10,1,9,8,36,51,0
Rodrygo,BRA,"FW,MF",Real Madrid,La Liga,23,2001,21.4,21,14,14,5,2,7,23,30.4,16,18,1,17,11,32,9,0
Mads Roerslev,DEN,DF,Brentford,Premier League,25,1999,12.2,18,8,14,3,1,11,28,39.3,17,12,5,7,4,22,35,0
Mads Roerslev,DEN,DF,Wolfsburg,Bundesliga,25,1999,3.3,10,9,8,1,1,6,9,66.7,3,2,2,0,5,15,16,0
Morgan Rogers,ENG,"FW,MF",Aston Villa,Premier League,22,2002,34.6,43,22,15,15,13,24,47,51.1,23,26,7,19,6,49,20,2
Merlin Röhl,GER,"MF,FW",Freiburg,Bundesliga,22,2002,10.7,16,10,4,10,2,9,11,81.8,2,9,1,8,6,22,2,0
Alessio Romagnoli,ITA,DF,Lazio,Serie A,29,1995,29.7,48,29,20,26,2,22,27,81.5,5,33,17,16,26,74,118,1
Leo Román,ESP,GK,Mallorca,La Liga,24,2000,7,0,0,0,0,0,0,0,,0,0,0,0,0,0,6,0
Carlos Romero,ESP,DF,Espanyol,La Liga,22,2001,28.4,73,47,49,16,8,45,82,54.9,37,50,15,35,30,103,102,1
Cristian Romero,ARG,DF,Tottenham,Premier League,26,1998,15.7,35,29,26,8,1,21,30,70,9,18,3,15,21,56,57,2
Isaac Romero,ESP,FW,Sevilla,La Liga,24,2000,24,13,7,4,4,5,3,16,18.8,13,18,1,17,7,20,27,0
Luka Romero,ARG,"FW,MF",Alavés,La Liga,19,2004,2.2,4,4,1,1,2,2,3,66.7,1,2,0,2,1,5,0,0
Oriol Romeu,ESP,MF,Girona,La Liga,32,1991,15.1,38,25,14,19,5,14,26,53.8,12,22,8,14,12,50,20,4
Valentin Rongier,FRA,"MF,DF",Marseille,Ligue 1,29,1994,17.4,50,28,14,31,5,27,43,62.8,16,30,9,21,33,83,28,5
Marten de Roon,NED,"MF,DF",Atalanta,Serie A,33,1991,34,74,48,32,38,4,30,66,45.5,36,40,7,33,47,121,67,1
Vitor Roque,BRA,FW,Betis,La Liga,19,2005,13.7,11,6,1,6,4,1,5,20,4,5,0,5,7,18,4,0
Pablo Rosario,DOM,"MF,DF",Nice,Ligue 1,27,1997,19.7,30,20,6,19,5,11,20,55,9,19,11,8,31,61,43,2
Lasse Rosenboom,GER,DF,Holstein Kiel,Bundesliga,22,2002,19.3,47,35,25,16,6,32,47,68.1,15,28,9,19,19,66,71,3
Max Rosenfelder,GER,DF,Freiburg,Bundesliga,21,2003,13.9,27,17,17,10,0,14,19,73.7,5,17,9,8,7,34,65,0
Valentin Rosier,FRA,DF,Leganés,La Liga,27,1996,28.8,72,52,48,16,8,43,68,63.2,25,40,15,25,52,124,149,2
Tom Rothe,GER,"DF,MF",Union Berlin,Bundesliga,19,2004,18.6,45,28,27,15,3,29,51,56.9,22,41,5,36,18,63,57,1
Anthony Rouault,FRA,DF,Rennes,Ligue 1,23,2001,10.8,12,8,10,2,0,4,4,100,0,13,11,2,8,20,65,0
Anthony Rouault,FRA,DF,Stuttgart,Bundesliga,23,2001,13.5,15,11,10,3,2,10,15,66.7,5,18,9,9,19,34,63,1
Jonas Rouhi,SWE,DF,Juventus,Serie A,20,2004,2.3,4,1,1,3,0,0,1,0,1,2,0,2,3,7,2,0
Jérôme Roussillon,FRA,"DF,MF",Union Berlin,Bundesliga,31,1993,1.5,0,0,0,0,0,0,2,0,2,0,0,0,2,2,7,0
Nicolò Rovella,ITA,MF,Lazio,Serie A,22,2001,30.2,84,50,39,38,7,41,79,51.9,38,19,4,15,47,131,46,3
Jon Rowe,ENG,"FW,MF",Marseille,Ligue 1,21,2003,9,15,11,5,4,6,6,14,42.9,8,4,1,3,2,17,4,0
Amir Rrahmani,KVX,DF,Napoli,Serie A,30,1994,37.8,39,31,19,19,1,16,25,64,9,43,26,17,27,66,179,2
Tommaso Rubino,ITA,MF,Fiorentina,Serie A,17,2006,0.1,0,0,0,0,0,0,1,0,1,0,0,0,0,0,0,0
Antonio Rüdiger,GER,DF,Real Madrid,La Liga,31,1993,25.5,20,13,14,6,0,11,15,73.3,4,22,14,8,9,29,96,1
Matteo Ruggeri,ITA,DF,Atalanta,Serie A,22,2002,19.5,39,24,15,14,10,25,39,64.1,14,30,4,26,22,61,50,1
Aitor Ruibal,ESP,"DF,FW",Betis,La Liga,28,1996,14.6,32,23,22,4,6,25,47,53.2,22,20,5,15,14,46,40,1
Abel Ruiz,ESP,FW,Girona,La Liga,24,2000,15,6,2,2,2,2,2,5,40,3,7,2,5,5,11,7,0
Ferrán Ruiz,ESP,MF,Girona,La Liga,21,2003,0.2,0,0,0,0,0,0,0,,0,2,1,1,1,1,0,0
Fabián Ruiz Peña,ESP,MF,Paris S-G,Ligue 1,28,1996,21.4,37,24,13,15,9,21,47,44.7,26,25,3,22,16,53,27,1
Gerónimo Rulli,ARG,GK,Marseille,Ligue 1,32,1992,34,4,3,4,0,0,4,8,50,4,1,0,1,1,5,25,3
Georginio Rutter,FRA,"MF,FW",Brighton,Premier League,22,2002,18.4,39,15,13,18,8,14,36,38.9,22,20,3,17,10,49,13,2
Mathew Ryan,AUS,GK,Lens,Ligue 1,32,1992,14,1,0,1,0,0,1,2,50,1,0,0,0,1,2,2,2
Julian Ryerson,NOR,DF,Dortmund,Bundesliga,26,1997,25.1,46,30,26,13,7,25,44,56.8,19,29,2,27,22,68,26,1
Frederik Rønnow,DEN,GK,Union Berlin,Bundesliga,31,1992,28,0,0,0,0,0,0,1,0,1,0,0,0,0,0,22,2
José Sá,POR,GK,Wolves,Premier League,31,1993,29,2,2,2,0,0,2,2,100,0,0,0,0,0,2,15,1
Elias Saad,TUN,"FW,MF",St. Pauli,Bundesliga,24,1999,10,20,13,7,8,5,10,20,50,10,14,0,14,3,23,1,0
Youssouf Sabaly,SEN,DF,Betis,La Liga,31,1993,17.6,40,25,21,15,4,24,32,75,8,21,4,17,13,53,40,0
Emmanuel Sabbi,USA,"FW,MF",Le Havre,Ligue 1,26,1997,7.3,14,7,7,4,3,5,8,62.5,3,2,0,2,3,17,4,0
Stefano Sabelli,ITA,DF,Genoa,Serie A,31,1993,22.9,58,31,27,25,6,20,52,38.5,32,28,7,21,22,80,65,0
Marcel Sabitzer,AUT,MF,Dortmund,Bundesliga,30,1994,18,29,19,7,15,7,16,27,59.3,11,19,6,13,10,39,29,1
Falaye Sacko,MLI,DF,Montpellier,Ligue 1,29,1995,13.7,14,8,9,4,1,9,19,47.4,10,17,7,10,13,27,21,0
Umar Sadiq,NGA,FW,Valencia,La Liga,27,1997,9.2,10,5,3,5,2,4,6,66.7,2,7,0,7,1,11,7,0
Umar Sadiq,NGA,FW,Real Sociedad,La Liga,27,1997,2.5,2,1,1,1,0,1,2,50,1,3,1,2,1,3,2,0
Alexis Saelemaekers,BEL,"DF,FW",Roma,Serie A,25,1999,15.4,33,20,22,7,4,18,35,51.4,17,12,1,11,9,42,8,1
Alexis Saelemaekers,BEL,"DF,FW",Milan,Serie A,25,1999,1,1,1,0,0,1,1,1,100,0,0,0,0,1,2,0,0
Jorge Sáenz,ESP,DF,Leganés,La Liga,27,1996,18.8,37,23,18,18,1,11,20,55,9,26,17,9,25,62,161,0
Matvei Safonov,RUS,GK,Paris S-G,Ligue 1,25,1999,9.8,0,0,0,0,0,0,0,,0,1,0,1,1,1,3,0
Modibo Sagnan,MLI,DF,Montpellier,Ligue 1,25,1999,23.8,57,35,38,16,3,26,44,59.1,18,24,13,11,29,86,110,5
Richie Sagrado,BEL,DF,Venezia,Serie A,20,2004,1.6,2,2,1,1,0,1,1,100,0,1,0,1,3,5,4,0
Osame Sahraoui,MAR,"FW,MF",Lille,Ligue 1,23,2001,14.4,13,9,4,4,5,3,8,37.5,5,14,1,13,7,20,8,1
Wesley Saïd,FRA,FW,Lens,Ligue 1,29,1995,10.1,16,11,3,10,3,6,13,46.2,7,6,0,6,2,18,2,0
Théo Sainte-Luce,FRA,DF,Montpellier,Ligue 1,25,1998,11.3,24,11,16,4,4,16,33,48.5,17,16,4,12,12,36,33,1
Bukayo Saka,ENG,"FW,MF",Arsenal,Premier League,22,2001,19.2,29,15,9,11,9,13,24,54.2,11,22,0,22,3,32,8,0
Faik Sakar,GER,MF,RB Leipzig,Bundesliga,16,2008,0,0,0,0,0,0,0,0,,0,0,0,0,0,0,0,0
Marco Sala,ITA,DF,Como,Serie A,25,1999,2.9,9,6,5,3,1,5,8,62.5,3,2,0,2,1,10,9,0
Marco Sala,ITA,DF,Lecce,Serie A,25,1999,0.8,1,0,0,1,0,0,1,0,1,1,0,1,0,1,0,0
Ibrahim Salah,MAR,FW,Brest,Ligue 1,22,2001,4,4,2,1,1,2,1,6,16.7,5,2,0,2,2,6,0,0
Mohamed Salah,EGY,FW,Liverpool,Premier League,32,1992,37.5,21,11,7,5,9,8,17,47.1,9,12,0,12,9,30,5,0
Anass Salah-Eddine,NED,DF,Roma,Serie A,22,2002,1.7,1,1,1,0,0,0,0,,0,0,0,0,1,2,2,2
Amine Salama,FRA,FW,Reims,Ligue 1,24,2000,4.1,3,2,0,2,1,0,3,0,3,2,1,1,1,4,0,0
Jan Salas,ESP,"MF,FW",Mallorca,La Liga,18,2005,0.5,3,1,2,1,0,2,2,100,0,0,0,0,0,3,0,0
Kike Salas,ESP,DF,Sevilla,La Liga,22,2002,24.9,47,28,24,16,7,27,46,58.7,19,26,14,12,32,79,146,0
Manolis Saliakas,GRE,"MF,DF",St. Pauli,Bundesliga,27,1996,25.7,46,22,24,18,4,25,49,51,24,38,8,30,20,66,62,0
William Saliba,FRA,DF,Arsenal,Premier League,23,2001,33.8,62,37,37,23,2,21,28,75,7,25,15,10,21,83,119,7
Mohammed Salisu,GHA,DF,Monaco,Ligue 1,25,1999,11.4,28,18,16,11,1,13,16,81.3,3,10,8,2,16,44,54,2
Roland Sallai,HUN,"FW,MF",Freiburg,Bundesliga,27,1997,0.5,2,1,1,1,0,0,0,,0,0,0,0,1,3,0,0
Yoann Salmier,GUF,DF,Le Havre,Ligue 1,31,1992,8.9,14,7,9,4,1,10,13,76.9,3,12,8,4,10,24,59,0
Lazar Samardzic,SRB,MF,Atalanta,Serie A,22,2002,13,21,15,5,7,9,12,25,48,13,9,1,8,2,23,6,0
Diadie Samassékou,MLI,MF,Hoffenheim,Bundesliga,28,1996,3.2,5,5,1,2,2,2,4,50,2,4,2,2,5,10,5,0
Mama Samba Baldé,GNB,FW,Lyon,Ligue 1,28,1995,0.4,2,2,0,2,0,0,0,,0,0,0,0,1,3,1,0
Mama Samba Baldé,GNB,FW,Brest,Ligue 1,28,1995,12.8,13,9,4,4,5,3,14,21.4,11,8,0,8,6,19,14,0
Brice Samba,FRA,GK,Rennes,Ligue 1,30,1994,17,2,1,2,0,0,1,2,50,1,0,0,0,0,2,12,3
Brice Samba,FRA,GK,Lens,Ligue 1,30,1994,15,0,0,0,0,0,0,0,,0,0,0,0,1,1,6,2
Albert Sambi Lokonga,BEL,MF,Sevilla,La Liga,24,1999,16.3,22,15,10,9,3,10,14,71.4,4,13,1,12,9,31,24,3
Junior Sambia,FRA,"DF,FW",Empoli,Serie A,27,1996,4.3,14,10,3,6,5,11,11,100,0,3,0,3,2,16,5,0
Chuky san jose,ESP,MF,Valladolid,La Liga,20,2004,8.1,8,2,3,3,2,2,9,22.2,7,4,1,3,0,8,4,0
Antonio Sanabria,PAR,FW,Torino,Serie A,28,1996,14.6,3,3,1,1,1,1,4,25,3,6,1,5,1,4,13,0
Oihan Sancet,ESP,MF,Athletic Club,La Liga,24,2000,18,13,8,6,6,1,5,14,35.7,9,10,0,10,5,18,6,0
Alexis Sánchez,CHI,FW,Udinese,Serie A,35,1988,4.9,3,1,0,2,1,1,7,14.3,6,5,0,5,4,7,1,1
Antonio Sánchez,ESP,"MF,DF",Mallorca,La Liga,27,1997,15.5,28,16,16,8,4,14,36,38.9,22,16,2,14,18,46,36,1
Iván Sánchez,ESP,"MF,FW",Valladolid,La Liga,31,1992,15.6,37,20,18,10,9,12,27,44.4,15,18,3,15,14,51,10,0
Javi Sánchez,ESP,DF,Valladolid,La Liga,27,1997,22.5,26,16,19,6,1,17,26,65.4,9,39,28,11,22,48,111,3
Juanlu Sánchez,ESP,"MF,DF",Sevilla,La Liga,20,2003,19.1,50,34,28,15,7,35,59,59.3,24,27,2,25,17,67,19,0
Manu Sánchez,ESP,DF,Alavés,La Liga,23,2000,29.3,83,56,40,33,10,41,69,59.4,28,51,12,39,30,113,76,1
Robert Sánchez,ESP,GK,Chelsea,Premier League,26,1997,32,0,0,0,0,0,0,1,0,1,0,0,0,2,2,24,10
Jadon Sancho,ENG,FW,Chelsea,Premier League,24,2000,19.6,13,7,3,3,7,5,12,41.7,7,11,0,11,2,15,8,2
Philipp Sander,GER,MF,Gladbach,Bundesliga,26,1998,15.6,33,17,16,15,2,10,23,43.5,13,16,7,9,23,56,44,3
James Sands,USA,"MF,DF",St. Pauli,Bundesliga,24,2000,5,15,6,5,8,2,4,4,100,0,5,1,4,5,20,8,0
Leroy Sané,GER,FW,Bayern Munich,Bundesliga,28,1996,18.2,23,15,4,8,11,12,23,52.2,11,8,0,8,7,30,3,0
Arouna Sangante,SEN,DF,Le Havre,Ligue 1,22,2002,13.8,25,16,11,14,0,10,17,58.8,7,11,5,6,21,46,65,3
Ibrahim Sangaré,CIV,MF,Nott'ham Forest,Premier League,26,1997,6.6,28,14,8,17,3,8,17,47.1,9,10,4,6,6,34,13,1
Nhoa Sangui,FRA,"DF,MF",Reims,Ligue 1,18,2006,12.9,16,9,6,6,4,9,12,75,3,8,4,4,8,24,23,0
Maroan Sannadi,MAR,FW,Athletic Club,La Liga,23,2001,8.4,5,0,1,4,0,2,7,28.6,5,1,0,1,1,6,2,1
Kaishu Sano,JPN,MF,Mainz 05,Bundesliga,23,2000,33.8,61,36,22,31,8,25,52,48.1,27,66,14,52,65,126,56,1
Morgan Sanson,FRA,MF,Nice,Ligue 1,29,1994,2.6,6,3,2,4,0,1,3,33.3,2,3,0,3,4,10,2,0
Nicola Sansone,ITA,"MF,FW",Lecce,Serie A,32,1991,0.7,0,0,0,0,0,0,0,,0,0,0,0,0,0,0,0
Baptiste Santamaria,FRA,MF,Nice,Ligue 1,29,1995,10.3,20,10,10,7,3,13,22,59.1,9,14,3,11,18,38,19,1
Baptiste Santamaria,FRA,MF,Rennes,Ligue 1,29,1995,5.4,11,4,7,3,1,6,11,54.5,5,10,4,6,12,23,7,0
Jesús Santiago,ESP,MF,Getafe,La Liga,20,2004,4.1,14,8,6,8,0,5,10,50,5,6,2,4,1,15,3,0
Andrey Santos,BRA,MF,Strasbourg,Ligue 1,20,2004,31.7,110,74,47,51,12,51,87,58.6,36,46,14,32,32,142,67,1
Kauã Santos,BRA,GK,Eint Frankfurt,Bundesliga,21,2003,8.5,0,0,0,0,0,0,0,,0,0,0,0,0,0,10,2
Tiago Santos,POR,DF,Lille,Ligue 1,22,2002,4.5,12,7,4,5,3,6,9,66.7,3,2,0,2,2,14,4,0
Pablo Sarabia,ESP,"MF,FW",Wolves,Premier League,32,1992,9,16,8,4,8,4,10,16,62.5,6,10,0,10,4,20,7,1
Jeremy Sarmiento,ECU,MF,Brighton,Premier League,22,2002,0.1,0,0,0,0,0,0,0,,0,0,0,0,0,0,0,0
Amin Sarr,SWE,FW,Hellas Verona,Serie A,23,2001,21.2,22,12,3,8,11,5,10,50,5,18,3,15,3,25,14,0
Ismaila Sarr,SEN,MF,Crystal Palace,Premier League,26,1998,30.1,22,10,10,9,3,8,25,32,17,27,8,19,9,31,40,0
Malang Sarr,FRA,DF,Lens,Ligue 1,25,1999,15.4,21,13,12,6,3,16,27,59.3,11,18,9,9,22,43,63,3
Mamadou Sarr,FRA,DF,Strasbourg,Ligue 1,18,2005,26.3,37,21,24,11,2,16,24,66.7,8,26,20,6,25,62,117,3
Martin Satriano,URU,"FW,DF",Lens,Ligue 1,23,2001,1,3,1,1,1,1,3,3,100,0,0,0,0,0,3,2,0
Razvan Sava,ROU,GK,Udinese,Serie A,22,2002,12,0,0,0,0,0,0,0,,0,0,0,0,0,0,6,2
Téji Savanier,FRA,MF,Montpellier,Ligue 1,32,1991,26.3,29,25,7,16,6,18,43,41.9,25,16,1,15,15,44,21,4
Sávio,BRA,"FW,MF",Manchester City,Premier League,20,2004,19.6,23,17,5,10,8,10,19,52.6,9,14,2,12,6,29,9,1
Nicolò Savona,ITA,DF,Juventus,Serie A,21,2003,19.2,29,13,19,9,1,13,25,52,12,12,3,9,11,40,38,0
Saba Sazonov,GEO,DF,Torino,Serie A,22,2002,0,0,0,0,0,0,0,0,,0,1,1,0,0,0,0,0
Joe Scally,USA,DF,Gladbach,Bundesliga,21,2002,28.6,45,32,25,18,2,27,46,58.7,19,35,11,24,16,61,86,2
Giorgio Scalvini,ITA,DF,Atalanta,Serie A,20,2003,3,8,4,5,3,0,5,9,55.6,4,0,0,0,4,12,7,0
Gianluca Scamacca,ITA,FW,Atalanta,Serie A,25,1999,0.1,0,0,0,0,0,0,0,,0,0,0,0,0,0,0,0
Oliver Scarles,ENG,"DF,FW",West Ham,Premier League,18,2005,7.4,21,11,17,3,1,14,22,63.6,8,14,2,12,11,32,26,0
Dane Scarlett,ENG,"FW,MF",Tottenham,Premier League,20,2004,0.4,1,0,0,1,0,0,0,,0,0,0,0,0,1,1,0
Kevin Schade,GER,FW,Brentford,Premier League,22,2001,25.5,39,25,17,10,12,13,23,56.5,10,19,4,15,5,44,34,0
András Schäfer,HUN,MF,Union Berlin,Bundesliga,25,1999,17,52,26,23,24,5,25,41,61,16,33,6,27,22,74,36,0
Fabian Schär,SUI,DF,Newcastle Utd,Premier League,32,1991,32.6,36,21,16,18,2,14,35,40,21,38,25,13,45,81,138,3
Patrik Schick,CZE,FW,Leverkusen,Bundesliga,28,1996,18.7,6,5,1,3,2,1,5,20,4,9,1,8,4,10,17,1
Stefan Schimmer,GER,"FW,MF",Heidenheim,Bundesliga,30,1994,2.7,2,0,1,1,0,1,2,50,1,1,0,1,0,2,4,0
Joël Schingtienne,BEL,DF,Venezia,Serie A,21,2002,12.5,27,16,18,7,2,12,19,63.2,7,18,9,9,14,41,25,5
Xaver Schlager,AUT,MF,RB Leipzig,Bundesliga,26,1997,2,4,2,2,1,1,3,7,42.9,4,7,0,7,0,4,3,0
Keven Schlotterbeck,GER,DF,Augsburg,Bundesliga,27,1997,14.4,19,17,9,9,1,12,16,75,4,13,6,7,15,34,73,1
Nico Schlotterbeck,GER,DF,Dortmund,Bundesliga,24,1999,22,38,24,21,16,1,27,45,60,18,31,15,16,22,60,79,1
Jeffrey Schlupp,GHA,"MF,DF",Crystal Palace,Premier League,31,1992,1.1,2,0,1,0,1,0,3,0,3,6,0,6,0,2,2,0
Romano Schmid,AUT,MF,Werder Bremen,Bundesliga,24,2000,31.5,43,25,10,22,11,24,51,47.1,27,42,3,39,11,54,9,2
Niklas Schmidt,GER,MF,Toulouse,Ligue 1,26,1998,2.3,6,4,1,5,0,4,7,57.1,3,0,0,0,1,7,4,0
Jan Schöppner,GER,MF,Heidenheim,Bundesliga,25,1999,29.8,56,30,19,27,10,20,58,34.5,38,38,6,32,43,99,95,1
Marvin Schulz,GER,"MF,DF",Holstein Kiel,Bundesliga,29,1995,3.4,6,5,2,2,2,2,8,25,6,12,8,4,0,6,17,0
Alexander Schwolow,GER,GK,Union Berlin,Bundesliga,32,1992,6,0,0,0,0,0,0,0,,0,0,0,0,0,0,2,1
Léo Scienza,BRA,"FW,MF",Heidenheim,Bundesliga,25,1998,12.8,17,12,10,5,2,7,18,38.9,11,13,1,12,5,22,9,1
Alex Scott,ENG,MF,Bournemouth,Premier League,20,2003,8.4,27,14,11,8,8,19,42,45.2,23,17,4,13,10,37,15,0
Simone Scuffet,ITA,GK,Cagliari,Serie A,28,1996,13,0,0,0,0,0,0,1,0,1,0,0,0,0,0,8,2
Simone Scuffet,ITA,GK,Napoli,Serie A,28,1996,1,0,0,0,0,0,0,0,,0,0,0,0,0,0,2,0
Jérémy Sebas,MTQ,"FW,MF",Strasbourg,Ligue 1,21,2003,2.1,3,2,1,1,1,2,3,66.7,1,2,0,2,0,3,4,0
Aleksandar Sedlar,SRB,DF,Alavés,La Liga,32,1991,6.6,18,10,7,11,0,8,10,80,2,2,1,1,10,28,24,1
Jacopo Seghetti,ITA,GK,Empoli,Serie A,19,2005,1,0,0,0,0,0,0,0,,0,0,0,0,0,0,0,0
Alidu Seidu,GHA,DF,Rennes,Ligue 1,24,2000,8.9,22,18,14,6,2,12,15,80,3,13,6,7,14,36,17,0
Nicolas Seiwald,AUT,"MF,DF",RB Leipzig,Bundesliga,23,2001,23.2,53,31,19,29,5,25,50,50,25,43,10,33,31,84,76,2
Hiroki Sekine,JPN,DF,Reims,Ligue 1,21,2002,9.9,9,7,6,2,1,7,17,41.2,10,22,11,11,5,14,51,1
Matz Sels,BEL,GK,Nott'ham Forest,Premier League,32,1992,38,1,1,1,0,0,1,1,100,0,0,0,0,0,1,26,1
Nélson Semedo,POR,DF,Wolves,Premier League,30,1993,32.1,62,36,32,21,9,34,57,59.6,23,32,10,22,23,85,104,3
Antoine Semenyo,GHA,FW,Bournemouth,Premier League,24,2000,35.6,55,35,17,25,13,16,43,37.2,27,67,9,58,11,66,39,2
Marvin Senaya,TOG,DF,Strasbourg,Ligue 1,23,2001,2.5,8,3,5,2,1,6,12,50,6,6,2,4,7,15,12,0
Marcos Senesi,ARG,DF,Bournemouth,Premier League,27,1997,12.3,39,21,23,14,2,14,31,45.2,17,16,7,9,14,53,58,0
Stefano Sensi,ITA,MF,Monza,Serie A,28,1995,3,8,5,4,4,0,5,6,83.3,1,4,2,2,3,11,3,1
Suat Serdar,GER,MF,Hellas Verona,Serie A,27,1997,15.3,35,22,12,19,4,10,26,38.5,16,19,4,15,8,43,21,0
Sergi,ESP,DF,Leganés,La Liga,32,1992,32.9,40,29,22,16,2,18,32,56.3,14,38,29,9,39,79,185,2
Nicolás Serrano,ESP,FW,Athletic Club,La Liga,21,2003,1.2,1,1,0,1,0,1,3,33.3,2,4,0,4,1,2,1,0
Benjamin Šeško,SVN,"FW,MF",RB Leipzig,Bundesliga,21,2003,26.4,7,3,0,4,3,3,11,27.3,8,15,4,11,5,12,20,0
Ryan Sessegnon,ENG,"FW,DF",Fulham,Premier League,24,2000,6.4,27,13,11,11,5,9,20,45,11,13,1,12,3,30,18,0
Stephan El Shaarawy,ITA,"DF,MF",Roma,Serie A,31,1992,12.2,16,12,4,6,6,6,12,50,6,4,0,4,10,26,13,0
Luke Shaw,ENG,DF,Manchester Utd,Premier League,29,1995,3.9,4,3,2,2,0,2,2,100,0,6,1,5,2,6,7,0
Alen Sherri,ALB,GK,Cagliari,Serie A,26,1997,6.9,1,0,1,0,0,1,2,50,1,0,0,0,1,2,1,0
Eldor Shomurodov,UZB,"FW,MF",Roma,Serie A,29,1995,12.2,14,6,2,7,5,3,6,50,3,10,1,9,3,17,5,0
Djibril Sidibé,FRA,DF,Toulouse,Ligue 1,32,1992,23.3,65,36,34,22,9,31,50,62,19,11,3,8,20,85,64,1
Armindo Sieb,GER,"FW,MF",Mainz 05,Bundesliga,21,2003,8.5,10,4,4,5,1,3,10,30,7,4,0,4,1,11,7,0
Benjamin Siegrist,SUI,GK,Genoa,Serie A,32,1992,1.7,0,0,0,0,0,0,0,,0,0,0,0,1,1,1,0
Vincent Sierro,SUI,MF,Toulouse,Ligue 1,28,1995,26.7,44,27,15,23,6,27,56,48.2,29,34,9,25,16,60,44,1
Tim Siersleben,GER,DF,Heidenheim,Bundesliga,24,2000,13.1,21,14,12,8,1,7,17,41.2,10,19,6,13,20,41,66,0
Zain Silcott-Duberry,MSR,FW,Bournemouth,Premier League,19,2005,0,1,1,0,0,1,1,1,100,0,0,0,0,0,1,0,0
Kiliann Sildillia,FRA,DF,Freiburg,Bundesliga,22,2002,8.9,17,10,8,6,3,7,13,53.8,6,16,5,11,11,28,38,0
André Silva,POR,FW,Werder Bremen,Bundesliga,28,1995,4.2,2,2,1,1,0,0,1,0,1,3,1,2,0,2,3,0
André Silva,POR,"FW,MF",RB Leipzig,Bundesliga,28,1995,1.5,1,1,1,0,0,0,1,0,1,1,0,1,1,2,2,0
Bernardo Silva,POR,"MF,FW",Manchester City,Premier League,29,1994,29.7,56,37,17,30,9,25,56,44.6,31,36,7,29,23,79,32,3
Caio Henrique Oliveira Silva,BRA,DF,Monaco,Ligue 1,27,1997,21.4,37,26,16,19,2,23,44,52.3,21,26,8,18,22,59,59,0
Fábio Silva,POR,FW,Las Palmas,La Liga,22,2002,20.7,12,7,4,5,3,4,14,28.6,10,12,0,12,4,16,27,0
Jota Silva,POR,"FW,MF",Nott'ham Forest,Premier League,24,1999,9.5,27,14,12,13,2,6,27,22.2,21,9,1,8,12,39,17,0
Eric da Silva Moreira,GER,"MF,DF",Nott'ham Forest,Premier League,18,2006,0.3,2,2,2,0,0,2,6,33.3,4,0,0,0,1,3,0,0
Rui Silva,POR,GK,Betis,La Liga,30,1994,15,0,0,0,0,0,0,1,0,1,1,0,1,0,0,7,0
Marco Silvestri,ITA,GK,Empoli,Serie A,33,1991,5,0,0,0,0,0,0,2,0,2,0,0,0,0,0,3,1
Abdallah Sima,SEN,"FW,MF",Brest,Ligue 1,23,2001,13.8,15,11,2,5,8,4,11,36.4,7,9,1,8,1,16,9,0
Mohamed Simakan,FRA,DF,RB Leipzig,Bundesliga,24,2000,0.6,0,0,0,0,0,0,0,,0,0,0,0,2,2,0,0
Giovanni Simeone,ARG,FW,Napoli,Serie A,29,1995,4.7,2,0,0,1,1,1,6,16.7,5,9,2,7,1,3,6,0
Giuliano Simeone,ARG,MF,Atlético Madrid,La Liga,21,2002,21.4,27,13,6,11,10,15,30,50,15,22,3,19,14,41,22,1
Moses Simon,NGA,"FW,MF",Nantes,Ligue 1,29,1995,29,20,14,4,7,9,7,22,31.8,15,11,0,11,12,32,13,0
Unai Simón,ESP,GK,Athletic Club,La Liga,27,1997,21,0,0,0,0,0,0,0,,0,1,0,1,1,1,14,4
Xavi Simons,NED,MF,RB Leipzig,Bundesliga,21,2003,23.9,28,21,5,15,8,12,26,46.2,14,19,3,16,12,40,19,1
Jahmai Simpson-Pusey,ENG,DF,Manchester City,Premier League,18,2005,1.1,1,0,1,0,0,0,1,0,1,1,1,0,0,1,2,0
Danel Sinani,LUX,"FW,MF",St. Pauli,Bundesliga,27,1997,13.9,14,11,2,7,5,6,14,42.9,8,12,1,11,1,15,13,0
Lassine Sinayoko,MLI,"FW,MF",Auxerre,Ligue 1,24,1999,25.5,33,20,10,14,9,11,23,47.8,12,16,2,14,13,46,38,0
Wilfried Singo,CIV,DF,Monaco,Ligue 1,23,2000,23.3,37,23,24,10,3,20,28,71.4,8,17,9,8,43,80,110,2
Luis Sinisterra,COL,"FW,MF",Bournemouth,Premier League,25,1999,2.6,7,2,3,2,2,0,4,0,4,3,0,3,1,8,8,0
Daley Sinkgraven,NED,DF,Las Palmas,La Liga,29,1995,1,5,1,3,2,0,1,3,33.3,2,1,0,1,1,6,2,0
Tobias Sippel,GER,GK,Gladbach,Bundesliga,36,1988,0.7,0,0,0,0,0,0,0,,0,0,0,0,0,0,0,0
Jailson Siqueira,BRA,"DF,MF",Celta Vigo,La Liga,28,1995,6.8,13,11,9,3,1,9,11,81.8,2,6,4,2,9,22,28,1
Ayanda Sishuba,BEL,FW,Rennes,Ligue 1,19,2005,0,1,0,1,0,0,1,1,100,0,0,0,0,0,1,0,0
Ibrahim Sissoko,MLI,FW,Saint-Étienne,Ligue 1,28,1995,9.1,11,9,5,3,3,2,5,40,3,10,2,8,2,13,13,0
Ibrahima Sissoko,MLI,MF,Bochum,Bundesliga,26,1997,29,66,44,30,31,5,24,45,53.3,21,39,11,28,36,102,61,0
Niama Sissoko,MLI,"FW,MF",Reims,Ligue 1,18,2005,0.5,0,0,0,0,0,0,0,,0,1,0,1,0,0,0,0
Antonio Sivera,ESP,GK,Alavés,La Liga,27,1996,31.2,2,1,2,0,0,2,2,100,0,1,0,1,0,2,20,0
Tim Skarke,GER,"FW,MF",Union Berlin,Bundesliga,27,1996,12.9,14,11,5,8,1,10,19,52.6,9,7,0,7,5,19,17,0
Ellyes Skhiri,TUN,MF,Eint Frankfurt,Bundesliga,29,1995,24.8,40,22,15,21,4,18,44,40.9,26,30,7,23,31,71,45,4
Oliver Skipp,ENG,MF,Leicester City,Premier League,23,2000,12.5,21,4,6,12,3,9,15,60,6,23,7,16,11,32,11,2
Leo Skiri Østigård,NOR,DF,Rennes,Ligue 1,24,1999,13.6,20,18,16,4,0,15,22,68.2,7,12,10,2,15,35,81,1
Leo Skiri Østigård,NOR,DF,Hoffenheim,Bundesliga,24,1999,10.3,9,7,5,4,0,4,6,66.7,2,17,9,8,9,18,111,0
Łukasz Skorupski,POL,GK,Bologna,Serie A,33,1991,26.3,1,0,1,0,0,1,3,33.3,2,0,0,0,0,1,13,2
Andreas Skov Olsen,DEN,"FW,MF",Wolfsburg,Bundesliga,24,1999,5.9,8,6,5,3,0,4,4,100,0,4,0,4,2,10,12,0
Robert Skov,DEN,"DF,MF",Union Berlin,Bundesliga,28,1996,9.5,15,11,8,7,0,10,20,50,10,8,1,7,8,23,9,0
Milan Škriniar,SVK,DF,Paris S-G,Ligue 1,29,1995,4.2,7,5,3,4,0,3,3,100,0,7,6,1,3,10,16,0
Steven Skrzybski,GER,"MF,FW",Holstein Kiel,Bundesliga,31,1992,14.7,19,6,7,6,6,7,24,29.2,17,16,0,16,11,30,11,0
Naatan Skyttä,FIN,FW,Toulouse,Ligue 1,22,2002,0.1,1,0,0,0,1,0,0,,0,0,0,0,0,1,0,0
William Smallbone,IRL,MF,Southampton,Premier League,24,2000,7.7,20,13,9,9,2,7,22,31.8,15,8,0,8,2,22,14,2
Adam Smith,ENG,DF,Bournemouth,Premier League,33,1991,17.7,24,12,11,7,6,14,27,51.9,13,13,5,8,15,39,49,1
Eric Smith,SWE,"DF,MF",St. Pauli,Bundesliga,27,1997,31.4,46,29,26,17,3,23,40,57.5,17,37,10,27,37,83,104,4
Justin Smith,CAN,MF,Espanyol,La Liga,21,2003,2.3,9,3,3,6,0,4,6,66.7,2,5,1,4,4,13,3,0
Emile Smith Rowe,ENG,MF,Fulham,Premier League,24,2000,22.7,31,18,7,14,10,8,24,33.3,16,22,2,20,11,42,16,0
Ivan Smolčić,CRO,DF,Como,Serie A,23,2000,7,16,9,8,7,1,9,13,69.2,4,8,2,6,10,26,24,0
Eduard Sobol,UKR,DF,Strasbourg,Ligue 1,29,1995,1.1,0,0,0,0,0,0,2,0,2,2,1,1,2,2,14,0
Simon Sohm,SUI,MF,Parma,Serie A,23,2001,33.2,28,17,11,13,4,16,35,45.7,19,11,3,8,26,54,36,0
Alex Sola,ESP,"MF,FW",Getafe,La Liga,25,1999,11.4,21,14,9,12,0,9,25,36,16,8,0,8,7,28,11,1
Arnau Solà,ESP,MF,Villarreal,La Liga,21,2003,0.1,0,0,0,0,0,0,2,0,2,1,1,0,0,0,0,0
Dominic Solanke,ENG,FW,Tottenham,Premier League,26,1997,24.5,18,11,1,12,5,4,16,25,12,20,9,11,1,19,23,0
Ola Solbakken,NOR,"MF,FW",Empoli,Serie A,25,1998,8.4,7,4,0,6,1,3,6,50,3,0,0,0,2,9,8,0
Carlos Soler,ESP,"MF,FW",West Ham,Premier League,27,1997,15.7,16,11,9,6,1,7,23,30.4,16,19,6,13,8,24,21,2
Julio Soler,ARG,"DF,FW",Bournemouth,Premier League,19,2005,0.1,1,1,1,0,0,1,1,100,0,1,0,1,0,1,0,0
Oumar Solet,FRA,DF,Udinese,Serie A,24,2000,18.6,33,19,18,13,2,21,30,70,9,32,19,13,17,50,78,4
Jhon Solis,COL,MF,Girona,La Liga,19,2004,5.9,13,7,3,9,1,6,14,42.9,8,13,1,12,4,17,6,1
Daniele Sommariva,ITA,GK,Genoa,Serie A,27,1997,0.3,0,0,0,0,0,0,0,,0,0,0,0,0,0,1,0
Yann Sommer,SUI,GK,Inter,Serie A,35,1988,32,0,0,0,0,0,0,0,,0,0,0,0,0,0,13,1
David Soria,ESP,GK,Getafe,La Liga,31,1993,38,4,4,4,0,0,4,5,80,1,0,0,0,1,5,21,3
Juan Soriano,ESP,GK,Leganés,La Liga,26,1997,6,1,1,1,0,0,1,1,100,0,0,0,0,0,1,2,0
Borna Sosa,CRO,DF,Torino,Serie A,26,1998,13.1,26,19,14,7,5,16,25,64,9,13,6,7,14,40,33,0
Ramón Sosa,PAR,"FW,MF",Nott'ham Forest,Premier League,24,1999,3.3,5,3,3,0,2,1,5,20,4,9,0,9,4,9,5,0
Hugo Sotelo,ESP,MF,Celta Vigo,La Liga,20,2003,13.9,28,17,8,10,10,13,31,41.9,18,9,1,8,5,33,9,1
Florian Sotoca,FRA,"FW,MF",Lens,Ligue 1,33,1990,19.9,22,13,3,8,11,12,22,54.5,10,12,2,10,14,36,25,0
Riccardo Sottil,ITA,"FW,MF",Fiorentina,Serie A,25,1999,9.3,5,4,3,1,1,3,4,75,1,1,0,1,4,9,3,0
Riccardo Sottil,ITA,"FW,MF",Milan,Serie A,25,1999,1.4,1,1,1,0,0,0,0,,0,0,0,0,0,1,0,0
Tomáš Souček,CZE,MF,West Ham,Premier League,29,1995,28.5,46,21,20,23,3,26,44,59.1,18,41,21,20,20,66,85,1
Matìas Soulé,ARG,"MF,DF",Roma,Serie A,21,2003,19.8,26,16,12,7,7,10,23,43.5,13,25,3,22,9,35,25,0
Boubakary Soumaré,FRA,MF,Leicester City,Premier League,25,1999,24.1,37,20,24,12,1,21,33,63.6,12,22,10,12,27,64,34,4
Issa Soumaré,SEN,"FW,MF",Le Havre,Ligue 1,23,2000,21.1,25,14,8,10,7,13,49,26.5,36,19,4,15,16,41,32,0
Djibril Sow,SUI,MF,Sevilla,La Liga,27,1997,22.9,25,14,13,10,2,8,17,47.1,9,18,3,15,28,53,26,1
Saidou Sow,GUI,DF,Strasbourg,Ligue 1,22,2002,11.3,9,5,6,3,0,6,12,50,6,15,9,6,15,24,37,2
Saidou Sow,GUI,DF,Nantes,Ligue 1,22,2002,8.9,17,11,13,4,0,6,10,60,4,19,12,7,13,30,46,1
Djed Spence,ENG,DF,Tottenham,Premier League,23,2000,19.9,47,34,25,15,7,23,30,76.7,7,28,9,19,21,68,74,2
Leonardo Spinazzola,ITA,"DF,FW",Napoli,Serie A,31,1993,16.9,17,10,6,9,2,10,23,43.5,13,12,1,11,9,26,31,1
Marco Sportiello,ITA,GK,Milan,Serie A,32,1992,1.4,0,0,0,0,0,0,0,,0,0,0,0,0,0,1,0
Anton Stach,GER,"MF,DF",Hoffenheim,Bundesliga,25,1998,28.7,66,46,25,37,4,32,47,68.1,15,47,13,34,46,112,101,2
Jens Stage,DEN,MF,Werder Bremen,Bundesliga,27,1996,24.5,49,30,22,24,3,25,46,54.3,21,44,10,34,18,67,42,2
Josip Stanišić,CRO,DF,Bayern Munich,Bundesliga,24,2000,9.7,13,11,6,4,3,7,15,46.7,8,10,6,4,6,19,29,1
Filip Stankovic,SRB,GK,Venezia,Serie A,22,2002,15.2,0,0,0,0,0,0,0,,0,0,0,0,0,0,11,2
Jay Stansfield,ENG,MF,Fulham,Premier League,21,2002,0,0,0,0,0,0,0,0,,0,0,0,0,0,0,0,0
Carl Starfelt,SWE,DF,Celta Vigo,La Liga,29,1995,25.2,40,20,25,14,1,18,27,66.7,9,29,21,8,31,71,129,3
Niklas Stark,GER,DF,Werder Bremen,Bundesliga,29,1995,23.4,33,21,20,11,2,14,21,66.7,7,41,27,14,36,69,129,1
Lucas Stassin,BEL,FW,Saint-Étienne,Ligue 1,19,2004,21,16,11,3,5,8,6,20,30,14,10,0,10,3,19,8,0
Jason Steele,ENG,GK,Brighton,Premier League,33,1990,2,0,0,0,0,0,0,0,,0,0,0,0,0,0,1,0
Orri Steinn Óskarsson,ISL,FW,Real Sociedad,La Liga,19,2004,10.5,6,6,2,1,3,2,8,25,6,10,1,9,2,8,11,0
Pascal Stenzel,GER,DF,Stuttgart,Bundesliga,28,1996,3.2,3,2,1,0,2,2,5,40,3,5,1,4,2,5,6,0
Jack Stephens,ENG,DF,Southampton,Premier League,30,1994,15.4,34,20,25,9,0,17,30,56.7,13,20,13,7,13,47,53,2
Leonidas Stergiou,SUI,DF,Stuttgart,Bundesliga,22,2002,9.5,24,13,9,11,4,16,19,84.2,3,16,5,11,14,38,39,0
Raheem Sterling,ENG,"FW,MF",Arsenal,Premier League,29,1994,5.5,9,4,1,3,5,5,10,50,5,3,0,3,1,10,4,0
Enzo Sternal,FRA,"FW,MF",Marseille,Ligue 1,17,2007,0.3,0,0,0,0,0,0,0,,0,0,0,0,0,0,0,0
Finley Stevens,WAL,DF,St. Pauli,Bundesliga,21,2003,0,0,0,0,0,0,0,0,,0,0,0,0,0,0,0,0
Ross Stewart,SCO,FW,Southampton,Premier League,28,1996,4.3,6,4,1,1,4,3,8,37.5,5,3,0,3,1,7,7,0
Angelo Stiller,GER,MF,Stuttgart,Bundesliga,23,2001,30.5,49,27,18,25,6,14,30,46.7,16,29,9,20,26,75,50,4
Kevin Stöger,AUT,MF,Gladbach,Bundesliga,30,1993,17.2,37,21,23,10,4,16,39,41,23,24,3,21,16,53,26,3
Stoichkov,ESP,"MF,FW",Alavés,La Liga,30,1993,7.8,14,9,6,7,1,6,11,54.5,5,2,0,2,1,15,7,0
Petar Stojanović,SVN,MF,Empoli,Serie A,28,1995,0,0,0,0,0,0,0,0,,0,0,0,0,0,0,0,0
Jakub Stolarczyk,POL,GK,Leicester City,Premier League,23,2000,10,2,1,2,0,0,1,2,50,1,0,0,0,0,2,6,1
John Stones,ENG,"DF,MF",Manchester City,Premier League,30,1994,6.1,6,2,3,2,1,5,5,100,0,5,3,2,4,10,19,1
Jørgen Strand Larsen,NOR,FW,Wolves,Premier League,24,2000,28.7,10,6,2,3,5,4,27,14.8,23,19,4,15,6,16,29,0
Gabriel Strefezza,BRA,"FW,MF",Como,Serie A,27,1997,29.1,57,39,20,20,17,21,55,38.2,34,24,2,22,13,70,26,0
Cristhian Stuani,URU,FW,Girona,La Liga,37,1986,12,9,7,1,7,1,5,8,62.5,3,4,1,3,7,16,11,0
Álex Suárez,ESP,DF,Las Palmas,La Liga,31,1993,27.3,40,23,30,9,1,20,27,74.1,7,39,24,15,13,53,107,2
Denis Suárez,ESP,MF,Villarreal,La Liga,30,1994,6.8,12,8,7,2,3,4,10,40,6,4,1,3,3,15,3,0
Gabriel Suazo,CHI,DF,Toulouse,Ligue 1,26,1997,24,59,39,25,22,12,30,72,41.7,42,27,3,24,36,95,40,1
Luka Sučić,CRO,MF,Real Sociedad,La Liga,21,2002,19.9,25,18,8,12,5,10,26,38.5,16,30,2,28,15,40,16,1
Yukinari Sugawara,JPN,"DF,MF",Southampton,Premier League,24,2000,17.3,31,18,16,14,1,19,31,61.3,12,21,10,11,11,42,53,3
Niklas Süle,GER,DF,Dortmund,Bundesliga,28,1995,11.7,14,12,9,5,0,10,14,71.4,4,11,6,5,4,18,46,1
Ibrahim Sulemana,GHA,MF,Atalanta,Serie A,21,2003,3.1,9,4,4,5,0,2,8,25,6,2,0,2,0,9,1,0
Kamaldeen Sulemana,GHA,"FW,MF",Southampton,Premier League,22,2002,15.6,22,17,9,5,8,10,15,66.7,5,16,4,12,6,28,9,0
Crysencio Summerville,NED,"FW,MF",West Ham,Premier League,22,2001,8.7,13,7,2,8,3,3,9,33.3,6,13,4,9,0,13,7,0
Tomáš Suslov,SVK,"MF,FW",Hellas Verona,Serie A,22,2002,23.1,54,38,23,24,7,23,72,31.9,49,30,2,28,18,72,17,1
Suso,ESP,"FW,MF",Sevilla,La Liga,30,1993,6.7,10,7,3,6,1,4,11,36.4,7,4,0,4,4,14,2,0
Zion Suzuki,JPN,GK,Parma,Serie A,21,2002,36.8,1,0,1,0,0,1,2,50,1,0,0,0,0,1,35,4
Mattias Svanberg,SWE,MF,Wolfsburg,Bundesliga,25,1999,13.5,20,10,6,11,3,9,19,47.4,10,11,4,7,15,35,26,0
Daniel Svensson,SWE,"DF,FW",Dortmund,Bundesliga,22,2002,8.7,15,11,5,6,4,7,11,63.6,4,10,4,6,5,20,30,0
Marin Šverko,CRO,DF,Venezia,Serie A,26,1998,12.4,20,9,14,6,0,10,12,83.3,2,10,5,5,16,36,45,3
Mile Svilar,SRB,GK,Roma,Serie A,24,1999,38,0,0,0,0,0,0,0,,0,0,0,0,0,0,12,2
Michael Svoboda,AUT,DF,Venezia,Serie A,25,1998,14.6,26,14,19,6,1,8,19,42.1,11,19,11,8,22,48,66,2
Williot Swedberg,SWE,"FW,MF",Celta Vigo,La Liga,20,2004,15,23,16,9,10,4,13,20,65,7,12,1,11,3,26,10,1
Abakar Sylla,CIV,DF,Strasbourg,Ligue 1,21,2002,10.6,27,15,14,11,2,15,17,88.2,2,18,10,8,11,38,63,0
Issiaga Sylla,GUI,DF,Montpellier,Ligue 1,30,1994,12.8,25,10,17,7,1,15,29,51.7,14,13,4,9,10,35,34,1
Mamadou Sylla,SEN,"FW,MF",Valladolid,La Liga,30,1994,17.6,8,4,3,3,2,2,9,22.2,7,8,0,8,3,11,14,1
Wojciech Szczęsny,POL,GK,Barcelona,La Liga,34,1990,15,1,1,1,0,0,0,0,,0,0,0,0,0,1,20,1
Sammie Szmodics,IRL,"FW,MF",Ipswich Town,Premier League,28,1995,11,16,10,4,10,2,7,26,26.9,19,10,2,8,6,22,14,0
Dominik Szoboszlai,HUN,MF,Liverpool,Premier League,23,2000,27.7,38,20,14,19,5,17,45,37.8,28,39,5,34,9,47,19,2
Alexander Sørloth,NOR,FW,Atlético Madrid,La Liga,28,1995,17.4,9,5,2,5,2,3,6,50,3,6,1,5,1,10,28,0
Musa Al-Taamari,JOR,"FW,MF",Montpellier,Ligue 1,27,1997,12.4,14,10,4,5,5,8,15,53.3,7,2,0,2,3,17,3,2
Musa Al-Taamari,JOR,"FW,MF",Rennes,Ligue 1,27,1997,6.3,4,1,1,1,2,0,4,0,4,5,0,5,2,6,2,0
Haris Tabakovic,BIH,FW,Hoffenheim,Bundesliga,30,1994,9.1,3,1,1,0,2,0,3,0,3,4,2,2,1,4,16,0
Nicolás Tagliafico,ARG,DF,Lyon,Ligue 1,31,1992,21.1,57,37,24,22,11,29,48,60.4,19,25,7,18,36,93,55,0
Jonathan Tah,GER,DF,Leverkusen,Bundesliga,28,1996,33,19,12,12,6,1,10,16,62.5,6,22,16,6,36,55,157,2
Adrien Tameze,CMR,"MF,DF",Torino,Serie A,30,1994,7.2,5,2,2,3,0,1,10,10,9,8,5,3,10,15,8,1
Axel Tapé,FRA,"DF,MF",Paris S-G,Ligue 1,16,2007,2,3,1,1,2,0,2,2,100,0,2,2,0,1,4,5,0
Renato Tapia,PER,"MF,DF",Leganés,La Liga,29,1995,26.9,61,35,30,27,4,24,50,48,26,58,23,35,27,88,86,2
Edmond Tapsoba,BFA,DF,Leverkusen,Bundesliga,25,1999,27.9,39,24,19,16,4,22,39,56.4,17,21,14,7,24,63,89,3
Florian Tardieu,FRA,MF,Saint-Étienne,Ligue 1,32,1992,13.9,18,14,6,9,3,6,17,35.3,11,18,5,13,15,33,21,0
Mehdi Taremi,IRN,FW,Inter,Serie A,32,1992,9,7,1,2,2,3,1,4,25,3,11,2,9,0,7,11,0
Matt Targett,ENG,DF,Newcastle Utd,Premier League,28,1995,0.2,0,0,0,0,0,0,1,0,1,0,0,0,1,1,1,0
Oussama Targhalline,MAR,MF,Le Havre,Ligue 1,22,2002,11,19,14,12,3,4,5,12,41.7,7,14,7,7,19,38,14,2
James Tarkowski,ENG,DF,Everton,Premier League,31,1992,32.5,64,40,39,22,3,24,39,61.5,15,57,42,15,41,105,213,4
César Tárrega,ESP,DF,Valencia,La Liga,22,2002,33.6,49,37,33,13,3,19,31,61.3,12,41,20,21,22,71,222,2
Nuno Tavares,POR,DF,Lazio,Serie A,24,2000,18.7,28,21,15,8,5,14,34,41.2,20,21,3,18,21,49,44,2
Marcus Tavernier,ENG,"FW,MF",Bournemouth,Premier League,25,1999,21.5,43,24,15,19,9,10,27,37,17,16,3,13,5,48,11,0
Charlie Taylor,ENG,DF,Southampton,Premier League,30,1993,4,7,5,4,3,0,5,7,71.4,2,8,5,3,5,12,31,1
Jack Taylor,IRL,MF,Ipswich Town,Premier League,26,1998,9.6,20,10,6,11,3,12,27,44.4,15,12,3,9,9,29,24,0
Loum Tchaouna,FRA,"FW,MF",Lazio,Serie A,20,2003,7.3,8,4,2,2,4,3,9,33.3,6,5,1,4,4,12,14,2
Jackson Tchatchoua,CMR,"DF,MF",Hellas Verona,Serie A,22,2001,35.2,50,31,34,13,3,28,43,65.1,15,21,9,12,14,64,75,2
Enzo Tchato,CMR,DF,Montpellier,Ligue 1,21,2002,21.1,48,26,26,18,4,26,44,59.1,18,30,10,20,22,70,59,0
Aurélien Tchouaméni,FRA,"DF,MF",Real Madrid,La Liga,24,2000,29.9,47,23,25,19,3,21,41,51.2,20,34,25,9,46,93,92,1
Álvaro Tejero,ESP,"MF,DF",Espanyol,La Liga,28,1996,13.8,14,4,7,6,1,7,23,30.4,16,9,1,8,13,27,34,1
Martín Tejón,ESP,"MF,DF",Valencia,La Liga,20,2004,0.5,2,0,0,2,0,1,2,50,1,0,0,0,0,2,0,0
Mathys Tel,FRA,FW,Tottenham,Premier League,19,2005,10.1,16,6,4,7,5,5,13,38.5,8,8,1,7,2,18,8,2
Mathys Tel,FRA,"FW,MF",Bayern Munich,Bundesliga,19,2005,2.8,2,2,0,2,0,0,0,,0,0,0,0,1,3,1,0
Nathan Tella,NGA,"MF,FW",Leverkusen,Bundesliga,25,1999,15.1,16,11,4,7,5,5,13,38.5,8,15,1,14,4,20,10,0
Nahuel Tenaglia,ARG,DF,Alavés,La Liga,28,1996,32.5,96,61,61,30,5,53,88,60.2,35,33,9,24,47,143,123,2
Arnau Tenas,ESP,GK,Paris S-G,Ligue 1,23,2001,1,0,0,0,0,0,0,0,,0,0,0,0,0,0,0,0
Casper Tengstedt,DEN,FW,Hellas Verona,Serie A,24,2000,16.9,7,5,0,5,2,4,9,44.4,5,5,1,4,4,11,29,0
Marc-André ter Stegen,GER,GK,Barcelona,La Liga,32,1992,7.5,0,0,0,0,0,0,1,0,1,0,0,0,0,0,2,2
Filippo Terracciano,ITA,"DF,MF",Milan,Serie A,21,2003,6,9,6,1,6,2,5,10,50,5,1,0,1,6,15,11,0
Pietro Terracciano,ITA,GK,Fiorentina,Serie A,34,1990,3,0,0,0,0,0,0,0,,0,0,0,0,0,0,0,0
Ramón Terrats,ESP,"MF,FW",Villarreal,La Liga,23,2000,1.5,3,3,1,2,0,2,4,50,2,3,1,2,2,5,3,0
Ramón Terrats,ESP,"MF,FW",Getafe,La Liga,23,2000,13.5,20,10,7,8,5,8,28,28.6,20,9,2,7,8,28,16,0
Martin Terrier,FRA,"MF,FW",Leverkusen,Bundesliga,27,1997,6.5,4,2,1,0,3,1,4,25,3,3,0,3,1,5,1,0
Tanner Tessmann,USA,MF,Lyon,Ligue 1,22,2001,13.7,25,15,11,10,4,12,25,48,13,13,7,6,19,44,29,1
Kenny Tete,NED,DF,Fulham,Premier League,28,1995,19.7,56,38,29,14,13,23,38,60.5,15,31,12,19,32,88,67,0
Teddy Teuma,MLT,MF,Reims,Ligue 1,30,1993,8.3,18,10,6,6,6,7,25,28,18,12,2,10,12,30,8,1
Jordan Teze,NED,DF,Monaco,Ligue 1,24,1999,6.3,18,9,8,9,1,7,16,43.8,9,12,1,11,6,24,15,0
Florian Thauvin,FRA,"FW,MF",Udinese,Serie A,31,1993,21.7,20,14,9,8,3,10,25,40,15,6,0,6,7,27,10,0
Arthur Theate,BEL,DF,Eint Frankfurt,Bundesliga,24,2000,30,36,25,19,16,1,22,44,50,22,42,19,23,39,75,170,3
Norman Theuerkauf,GER,MF,Heidenheim,Bundesliga,37,1987,0.2,0,0,0,0,0,0,0,,0,0,0,0,0,0,0,0
Thiago,BRA,"FW,MF",Brentford,Premier League,23,2001,1.9,5,3,2,1,2,0,1,0,1,3,0,3,2,7,3,1
Malick Thiaw,GER,DF,Milan,Serie A,22,2001,20.1,24,17,15,6,3,6,10,60,4,14,12,2,15,39,76,1
Denis Thomalla,GER,MF,Heidenheim,Bundesliga,31,1992,0,0,0,0,0,0,0,0,,0,0,0,0,0,0,0,0
Luke Thomas,ENG,DF,Leicester City,Premier League,23,2001,12.3,31,25,23,5,3,21,41,51.2,20,15,6,9,21,52,49,1
Sorba Thomas,WAL,"FW,MF",Nantes,Ligue 1,24,1999,14.7,14,6,7,5,2,10,18,55.6,8,12,2,10,9,23,27,1
Adrien Thomasson,FRA,MF,Lens,Ligue 1,30,1993,29.1,90,47,42,25,23,52,95,54.7,43,48,3,45,19,109,28,2
Morten Thorsby,NOR,"MF,FW",Genoa,Serie A,28,1996,21.1,49,30,19,20,10,17,29,58.6,12,22,1,21,5,54,28,1
Khéphren Thuram,FRA,MF,Juventus,Serie A,23,2001,25.8,44,21,16,24,4,18,32,56.3,14,32,10,22,14,58,39,2
Marcus Thuram,FRA,FW,Inter,Serie A,26,1997,24.4,18,8,7,5,6,3,14,21.4,11,16,3,13,3,21,15,0
Cheikh Tidiane Niasse,SEN,MF,Hellas Verona,Serie A,24,2000,8.4,18,15,6,12,0,10,19,52.6,9,17,4,13,17,35,17,2
Youri Tielemans,BEL,MF,Aston Villa,Premier League,27,1997,33.6,84,58,32,44,8,40,73,54.8,33,38,16,22,23,107,47,4
Kieran Tierney,SCO,"DF,FW",Arsenal,Premier League,27,1997,2.9,7,5,4,1,2,4,6,66.7,2,0,0,0,3,10,9,0
Phillip Tietz,GER,FW,Augsburg,Bundesliga,27,1997,18.7,11,6,2,7,2,5,8,62.5,3,10,1,9,5,16,26,1
Jurriën Timber,NED,DF,Arsenal,Premier League,23,2001,26.9,58,38,17,30,11,18,27,66.7,9,19,4,15,22,80,44,1
Jean-Clair Todibo,FRA,DF,West Ham,Premier League,24,1999,20.3,47,28,30,15,2,26,36,72.2,10,25,13,12,26,73,83,3
Harry Toffolo,ENG,DF,Nott'ham Forest,Premier League,28,1995,1.5,5,3,3,1,1,3,4,75,1,2,2,0,2,7,12,0
Umut Tohumcu,GER,"MF,FW",Hoffenheim,Bundesliga,19,2004,4.2,9,5,3,5,1,5,7,71.4,2,5,0,5,3,12,6,0
Corentin Tolisso,FRA,MF,Lyon,Ligue 1,29,1994,25.9,57,25,21,26,10,34,65,52.3,31,52,13,39,22,79,41,1
John Tolkin,USA,"DF,MF",Holstein Kiel,Bundesliga,22,2002,8.2,18,11,11,7,0,12,14,85.7,2,10,2,8,8,26,54,0
Rafael Tolói,ITA,DF,Atalanta,Serie A,33,1990,5.2,10,5,3,5,2,4,11,36.4,7,8,2,6,8,18,11,0
Raúl de Tomás,ESP,"DF,FW",Rayo Vallecano,La Liga,29,1994,0.2,2,2,1,0,1,0,0,,0,0,0,0,0,2,0,0
Tiago Tomás,POR,"FW,MF",Wolfsburg,Bundesliga,22,2002,20.9,33,19,15,11,7,15,35,42.9,20,17,4,13,9,42,19,0
Takehiro Tomiyasu,JPN,DF,Arsenal,Premier League,25,1998,0.1,0,0,0,0,0,0,0,,0,0,0,0,0,0,1,0
Fikayo Tomori,ENG,DF,Milan,Serie A,26,1997,17.7,40,25,21,16,3,17,25,68,8,17,12,5,20,60,61,2
Sandro Tonali,ITA,MF,Newcastle Utd,Premier League,24,2000,29.2,51,32,22,23,6,25,51,49,26,34,11,23,34,85,33,2
Luka Topalović,SVN,MF,Inter,Serie A,18,2006,0.1,1,1,0,1,0,0,0,,0,0,0,0,0,1,0,0
Pablo Torre,ESP,"MF,FW",Barcelona,La Liga,21,2003,3.4,5,4,1,3,1,2,4,50,2,0,0,0,3,8,5,1
David Torres,ESP,DF,Valladolid,La Liga,21,2003,15.4,13,8,12,1,0,7,11,63.6,4,19,17,2,10,23,74,0
Ferrán Torres,ESP,"FW,MF",Barcelona,La Liga,24,2000,12.3,8,4,2,3,3,3,8,37.5,5,7,1,6,4,12,5,0
Pau Torres,ESP,DF,Aston Villa,Premier League,27,1997,22.4,21,15,11,8,2,10,17,58.8,7,16,11,5,10,31,75,2
Lucas Torró,ESP,MF,Osasuna,La Liga,30,1994,32.9,74,41,34,35,5,36,64,56.3,28,36,9,27,45,119,70,3
Lorenzo Tosto,ITA,DF,Empoli,Serie A,18,2006,0,0,0,0,0,0,0,0,,0,0,0,0,0,0,0,0
Abdoulaye Touré,GUI,MF,Le Havre,Ligue 1,30,1994,25.8,61,34,31,21,9,33,59,55.9,26,36,19,17,34,95,42,5
Bazoumana Touré,CIV,"FW,MF",Hoffenheim,Bundesliga,18,2006,6.8,12,10,2,7,3,2,8,25,6,4,0,4,3,15,2,0
Birama Touré,MLI,"MF,DF",Montpellier,Ligue 1,32,1992,3.3,8,5,5,2,1,4,6,66.7,2,3,2,1,6,14,7,0
Ousmane Toure,FRA,DF,Lille,Ligue 1,19,2005,0.1,0,0,0,0,0,0,0,,0,0,0,0,1,1,2,0
Souleymane Touré,FRA,DF,Udinese,Serie A,21,2003,8.1,7,6,4,3,0,4,5,80,1,15,6,9,9,16,17,1
Lucas Tousart,FRA,MF,Union Berlin,Bundesliga,27,1997,6.2,17,9,6,9,2,5,12,41.7,7,11,4,7,7,24,27,0
Conor Townsend,ENG,DF,Ipswich Town,Premier League,31,1993,3.7,11,8,9,2,0,8,11,72.7,3,8,6,2,4,15,16,0
Adama Traoré,ESP,"FW,MF",Fulham,Premier League,28,1996,19.7,20,13,9,6,5,5,13,38.5,8,7,0,7,1,21,6,4
Boubacar Traoré,MLI,MF,Wolves,Premier League,22,2001,0,2,0,0,2,0,1,1,100,0,0,0,0,0,2,0,0
Hamari Traoré,MLI,DF,Real Sociedad,La Liga,32,1992,7.8,19,12,10,7,2,15,22,68.2,7,6,2,4,9,28,21,0
Omar Traoré,GER,DF,Heidenheim,Bundesliga,26,1998,29.1,50,26,31,16,3,25,41,61,16,35,6,29,21,71,66,0
Kevin Trapp,GER,GK,Eint Frankfurt,Bundesliga,34,1990,25.5,0,0,0,0,0,0,0,,0,0,0,0,0,0,13,3
Mark Travers,IRL,GK,Bournemouth,Premier League,25,1999,5,0,0,0,0,0,0,0,,0,0,0,0,0,0,5,0
Óscar Trejo,ARG,MF,Rayo Vallecano,La Liga,36,1988,5.5,8,5,1,5,2,3,9,33.3,6,9,0,9,4,12,5,0
Philipp Treu,GER,"MF,DF",St. Pauli,Bundesliga,23,2000,32,61,42,35,17,9,39,68,57.4,29,52,12,40,19,80,87,2
Ryan Trevitt,ENG,MF,Brentford,Premier League,21,2003,0,1,1,1,0,0,0,0,,0,0,0,0,0,1,0,0
Christopher Trimmel,AUT,"DF,MF",Union Berlin,Bundesliga,37,1987,19.3,38,25,23,14,1,28,42,66.7,14,14,6,8,18,56,92,0
Kieran Trippier,ENG,DF,Newcastle Utd,Premier League,33,1990,14.5,38,21,18,14,6,22,36,61.1,14,11,3,8,12,50,49,0
Leandro Trossard,BEL,FW,Arsenal,Premier League,29,1994,28.3,31,20,6,16,9,12,34,35.3,22,32,0,32,9,40,18,0
Adrien Truffert,FRA,"DF,MF",Rennes,Ligue 1,22,2001,30.6,61,36,27,21,13,32,48,66.7,16,44,6,38,27,88,56,1
Kostas Tsimikas,GRE,DF,Liverpool,Premier League,28,1996,9.3,31,20,15,11,5,14,23,60.9,9,5,2,3,11,42,20,0
Viktor Tsyhankov,UKR,"FW,MF",Girona,La Liga,26,1997,21.3,19,12,4,7,8,9,19,47.4,10,7,1,6,15,34,16,1
Axel Tuanzebe,COD,DF,Ipswich Town,Premier League,26,1997,19,31,19,21,4,6,17,26,65.4,9,21,10,11,23,54,56,1
Stefano Turati,ITA,GK,Monza,Serie A,22,2001,29.7,0,0,0,0,0,0,1,0,1,0,0,0,0,0,21,2
Beñat Turrientes,ESP,MF,Real Sociedad,La Liga,22,2002,10.5,15,6,4,10,1,4,15,26.7,11,15,3,12,5,20,14,1
Tuta,BRA,"DF,MF",Eint Frankfurt,Bundesliga,25,1999,25.3,44,27,25,17,2,28,40,70,12,42,21,21,40,84,135,1
Christantus Uche,NGA,"FW,MF",Getafe,La Liga,21,2003,27.6,35,21,8,19,8,9,20,45,11,20,2,18,10,45,19,0
Destiny Udogie,ITA,DF,Tottenham,Premier League,21,2002,21.4,75,47,42,26,7,33,48,68.8,15,40,6,34,22,97,36,1
Manuel Ugarte Ribeiro,URU,MF,Manchester Utd,Premier League,23,2001,19.8,77,49,34,34,9,30,68,44.1,38,33,4,29,27,104,17,2
Lesley Ugochukwu,FRA,MF,Southampton,Premier League,20,2004,18.4,50,24,16,30,4,18,36,50,18,27,10,17,14,64,23,2
Lukas Ullrich,GER,DF,Gladbach,Bundesliga,20,2004,21.1,25,16,18,6,1,15,42,35.7,27,26,9,17,23,48,74,1
Sven Ulreich,GER,GK,Bayern Munich,Bundesliga,35,1988,1,0,0,0,0,0,0,0,,0,0,0,0,0,0,0,0
Enes Ünal,TUR,"FW,MF",Bournemouth,Premier League,27,1997,3.8,1,0,0,0,1,0,3,0,3,1,0,1,0,1,6,0
Deniz Undav,GER,"FW,MF",Stuttgart,Bundesliga,28,1996,19.2,11,10,2,3,6,1,17,5.9,16,15,2,13,3,14,10,0
Naci Ünüvar,NED,"MF,DF",Espanyol,La Liga,21,2003,0.3,2,2,1,1,0,1,2,50,1,0,0,0,0,2,0,0
Dayot Upamecano,FRA,DF,Bayern Munich,Bundesliga,25,1998,19.5,36,22,18,16,2,16,29,55.2,13,17,7,10,34,70,45,1
Kacper Urbanski,POL,MF,Bologna,Serie A,19,2004,2.7,5,2,4,0,1,4,6,66.7,2,5,1,4,2,7,5,0
Kacper Urbanski,POL,MF,Monza,Serie A,19,2004,5.6,5,3,1,2,2,4,7,57.1,3,7,2,5,2,7,9,0
Jonas Urbig,GER,GK,Bayern Munich,Bundesliga,20,2003,8,0,0,0,0,0,0,0,,0,0,0,0,0,0,9,2
Can Uzun,TUR,"MF,FW",Eint Frankfurt,Bundesliga,18,2005,7.5,10,4,1,4,5,5,10,50,5,9,0,9,1,11,3,0
Josha Vagnoman,GER,"DF,MF",Stuttgart,Bundesliga,23,2000,20.4,26,14,11,13,2,17,34,50,17,16,2,14,14,40,57,1
Lautaro Valenti,ARG,DF,Parma,Serie A,25,1999,17.3,17,12,13,3,1,7,9,77.8,2,26,13,13,13,30,94,1
Óscar Valentín,ESP,MF,Rayo Vallecano,La Liga,29,1994,20.4,55,41,21,20,14,33,76,43.4,43,36,8,28,21,76,51,2
Nicolás Valentini,ARG,DF,Hellas Verona,Serie A,23,2001,12.5,35,23,22,12,1,20,31,64.5,11,15,7,8,15,50,97,0
Germán Valera,ESP,MF,Valencia,La Liga,22,2002,1.6,1,1,1,0,0,0,1,0,1,2,0,2,4,5,2,1
Emanuele Valeri,ITA,DF,Parma,Serie A,25,1998,31.9,51,31,33,15,3,30,61,49.2,31,31,10,21,29,80,103,4
Martin Valjent,SVK,DF,Mallorca,La Liga,28,1995,30.7,30,21,22,7,1,15,25,60,10,32,21,11,18,48,195,1
Álex Valle,ESP,DF,Como,Serie A,20,2004,11.4,26,12,12,12,2,15,21,71.4,6,13,2,11,8,34,42,0
Jesús Vallejo,ESP,DF,Real Madrid,La Liga,27,1997,1.5,0,0,0,0,0,0,0,,0,0,0,0,2,2,8,0
Mattia Valoti,ITA,MF,Monza,Serie A,30,1993,0.4,3,3,3,0,0,0,2,0,2,2,0,2,0,3,2,0
Federico Valverde,URU,"MF,DF",Real Madrid,La Liga,26,1998,33.7,50,30,22,23,5,29,43,67.4,14,38,8,30,55,105,52,1
Ignace Van Der Brempt,BEL,DF,Como,Serie A,22,2002,14,40,32,27,10,3,24,33,72.7,9,14,5,9,17,57,34,0
Siebe Van Der Heyden,BEL,"DF,MF",Mallorca,La Liga,26,1998,1.1,1,1,0,1,0,0,0,,0,1,0,1,2,3,3,0
Siebe Van Der Heyden,BEL,"DF,MF",St. Pauli,Bundesliga,26,1998,9.7,17,10,10,7,0,8,18,44.4,10,8,4,4,17,34,43,2
Virgil van Dijk,NED,DF,Liverpool,Premier League,33,1991,37,38,20,17,19,2,13,22,59.1,9,27,16,11,56,94,190,4
Vanderson,BRA,DF,Monaco,Ligue 1,23,2001,22.9,76,48,37,30,9,45,64,70.3,19,43,6,37,39,115,65,2
Maarten Vandevoordt,BEL,GK,RB Leipzig,Bundesliga,22,2002,4.8,1,0,1,0,0,1,1,100,0,0,0,0,0,1,4,0
Jamie Vardy,ENG,FW,Leicester City,Premier League,37,1987,31.4,19,13,7,7,5,4,13,30.8,9,8,4,4,5,24,24,0
Ruben Vargas,SUI,"FW,MF",Sevilla,La Liga,25,1998,7.5,7,4,1,5,1,3,8,37.5,5,9,0,9,3,10,10,0
Ruben Vargas,SUI,"MF,FW",Augsburg,Bundesliga,25,1998,3.4,2,1,1,1,0,1,4,25,3,1,0,1,2,4,1,1
Nikola Vasilj,BIH,GK,St. Pauli,Bundesliga,28,1995,33,0,0,0,0,0,0,2,0,2,0,0,0,0,0,22,3
Devis Vásquez,COL,GK,Empoli,Serie A,26,1998,32,0,0,0,0,0,0,0,,0,0,0,0,0,0,21,4
Johan Vásquez,MEX,DF,Genoa,Serie A,25,1998,33.8,56,31,24,27,5,26,44,59.1,18,59,31,28,50,106,150,1
Denis Vavro,SVK,DF,Wolfsburg,Bundesliga,28,1996,27.3,21,13,16,5,0,11,23,47.8,12,48,32,16,37,58,234,3
José Luis García Vayá,ESP,MF,Valencia,La Liga,25,1998,19.4,43,25,24,13,6,19,33,57.6,14,23,6,17,19,62,42,0
Robinio Vaz,FRA,FW,Marseille,Ligue 1,17,2007,0.8,1,1,0,0,1,0,2,0,2,0,0,0,0,1,2,0
Jesus Vazquez,ESP,DF,Valencia,La Liga,21,2003,10.2,23,18,12,9,2,10,19,52.6,9,16,5,11,10,33,30,0
Lucas Vázquez,ESP,DF,Real Madrid,La Liga,33,1991,24.3,58,34,33,17,8,27,48,56.3,21,24,6,18,17,75,35,1
Matías Vecino,URU,MF,Lazio,Serie A,32,1991,9.7,13,7,3,9,1,4,18,22.2,14,9,3,6,5,18,15,0
Danilo Veiga,POR,DF,Lecce,Serie A,21,2002,4.2,8,6,4,4,0,6,13,46.2,7,5,0,5,4,12,14,0
Renato Veiga,POR,"DF,MF",Chelsea,Premier League,21,2003,2,9,6,6,3,0,4,12,33.3,8,3,1,2,1,10,2,0
Renato Veiga,POR,DF,Juventus,Serie A,21,2003,12.1,17,12,7,9,1,9,14,64.3,5,17,13,4,19,36,81,0
Alejo Véliz,ARG,FW,Espanyol,La Liga,20,2003,12.5,1,1,0,1,0,1,7,14.3,6,12,2,10,4,5,23,1
Miloš Veljković,SRB,DF,Werder Bremen,Bundesliga,28,1995,11.4,10,5,6,3,1,7,15,46.7,8,14,9,5,2,12,47,1
Joël Veltman,NED,DF,Brighton,Premier League,32,1992,18.9,43,29,24,16,3,31,52,59.6,21,22,7,15,19,62,66,0
Micky van de Ven,NED,DF,Tottenham,Premier League,23,2001,11.3,10,6,5,4,1,8,14,57.1,6,12,8,4,10,20,39,1
Lorenzo Venturino,ITA,"FW,MF",Genoa,Serie A,18,2006,1.9,5,3,4,0,1,3,6,50,3,3,0,3,0,5,5,0
Nikolas Veratschnig,AUT,"DF,MF",Mainz 05,Bundesliga,21,2003,4,9,6,1,4,4,2,3,66.7,1,4,0,4,5,14,8,0
Bart Verbruggen,NED,GK,Brighton,Premier League,21,2002,36,0,0,0,0,0,0,3,0,3,1,0,1,0,0,29,5
Simone Verdi,ITA,"MF,FW",Como,Serie A,32,1992,1.3,2,2,0,1,1,0,2,0,2,2,0,2,0,2,2,0
Jordan Veretout,FRA,MF,Lyon,Ligue 1,31,1993,17.3,30,14,14,14,2,17,40,42.5,23,17,3,14,5,35,23,1
Arthur Vermeeren,BEL,MF,RB Leipzig,Bundesliga,19,2005,17.5,32,19,14,13,5,14,47,29.8,33,34,12,22,23,55,25,2
Yorbe Vertessen,BEL,"MF,FW",Union Berlin,Bundesliga,23,2001,8,6,3,3,2,1,2,8,25,6,6,0,6,3,9,6,0
Mikel Vesga,ESP,MF,Athletic Club,La Liga,31,1993,11,22,15,7,13,2,12,28,42.9,16,10,1,9,15,37,26,0
Jannik Vestergaard,DEN,DF,Leicester City,Premier League,31,1992,15.5,22,10,16,6,0,9,15,60,6,21,14,7,16,38,74,1
Ben Viadere,FRA,MF,Auxerre,Ligue 1,18,2005,0.1,0,0,0,0,0,0,0,,0,0,0,0,0,0,0,0
Guglielmo Vicario,ITA,GK,Tottenham,Premier League,27,1996,24,0,0,0,0,0,0,0,,0,0,0,0,1,1,14,6
Carlos Vicente,ESP,"FW,MF",Alavés,La Liga,25,1999,34.4,47,31,26,11,10,25,64,39.1,39,34,2,32,14,61,40,0
Pau Victor,ESP,FW,Barcelona,La Liga,22,2001,3.5,3,1,0,2,1,0,3,0,3,6,1,5,2,5,5,0
Nacho Vidal,ESP,DF,Osasuna,La Liga,29,1995,1.4,2,0,0,1,1,1,4,25,3,1,0,1,0,2,6,0
Gabriel Vidovic,CRO,MF,Mainz 05,Bundesliga,20,2003,0,0,0,0,0,0,0,0,,0,0,0,0,0,0,0,0
Gabriel Vidovic,CRO,MF,Bayern Munich,Bundesliga,20,2003,0.3,0,0,0,0,0,0,0,,0,2,0,2,0,0,0,0
Fran Vieites,ESP,GK,Betis,La Liga,25,1999,4,0,0,0,0,0,0,0,,0,0,0,0,0,0,1,0
Sergio Viera,ESP,MF,Las Palmas,La Liga,19,2005,1.1,1,1,0,1,0,0,1,0,1,1,0,1,1,2,1,0
Samuele Vignato,ITA,MF,Monza,Serie A,20,2004,5.2,6,3,0,4,2,3,7,42.9,4,1,0,1,0,6,6,0
Asier Villalibre,ESP,FW,Alavés,La Liga,26,1997,3.7,2,2,0,1,1,1,2,50,1,1,0,1,1,3,7,0
Iván Villar,ESP,GK,Celta Vigo,La Liga,27,1997,4,0,0,0,0,0,0,0,,0,0,0,0,0,0,3,0
Carlos Vinícius,BRA,"MF,FW",Fulham,Premier League,29,1995,0.2,0,0,0,0,0,0,1,0,1,1,0,1,0,0,0,0
Nicolas Viola,ITA,"FW,MF",Cagliari,Serie A,34,1989,14.1,14,7,6,7,1,1,10,10,9,5,0,5,3,17,5,0
Viti,ESP,DF,Las Palmas,La Liga,26,1997,22,71,46,43,21,7,31,45,68.9,14,28,7,21,27,98,61,0
Mattia Viti,ITA,DF,Empoli,Serie A,22,2002,28.6,65,45,42,20,3,34,52,65.4,18,41,18,23,48,113,128,4
Vitinha,POR,"FW,MF",Genoa,Serie A,24,2000,14.8,23,8,12,6,5,11,30,36.7,19,14,2,12,12,35,22,0
Vitinha,POR,MF,Paris S-G,Ligue 1,24,2000,22.7,43,23,13,27,3,25,48,52.1,23,26,7,19,14,57,19,2
Daniel Vivian,ESP,DF,Athletic Club,La Liga,25,1999,29,40,26,23,14,3,21,32,65.6,11,26,10,16,47,87,152,2
Krapyvtsov Vladyslav,UKR,GK,Girona,La Liga,19,2005,2,0,0,0,0,0,0,0,,0,0,0,0,0,0,1,1
Dušan Vlahović,SRB,FW,Juventus,Serie A,24,2000,19.8,4,2,0,1,3,1,5,20,4,7,3,4,1,5,9,3
Vanja Vlahović,SRB,"FW,MF",Atalanta,Serie A,20,2004,0.7,1,1,0,0,1,0,0,,0,0,0,0,0,1,0,0
Nikola Vlašić,CRO,"MF,FW",Torino,Serie A,26,1997,23.5,37,19,11,17,9,12,30,40,18,15,3,12,9,46,15,0
Alessandro Vogliacco,ITA,DF,Genoa,Serie A,25,1998,7.9,15,3,7,7,1,10,12,83.3,2,11,7,4,9,24,20,0
Alessandro Vogliacco,ITA,DF,Parma,Serie A,25,1998,8.6,5,2,5,0,0,3,5,60,2,15,10,5,3,8,37,0
Kevin Vogt,GER,DF,Union Berlin,Bundesliga,32,1991,15.2,12,8,7,5,0,8,13,61.5,5,16,8,8,9,21,75,1
Mërgim Vojvoda,KVX,DF,Torino,Serie A,29,1995,12.3,18,10,5,9,4,7,14,50,7,13,3,10,7,25,24,1
Mërgim Vojvoda,KVX,DF,Como,Serie A,29,1995,8,9,6,5,4,0,7,9,77.8,2,7,4,3,3,12,18,0
Kevin Volland,GER,"FW,MF",Union Berlin,Bundesliga,32,1992,0.7,0,0,0,0,0,0,0,,0,1,0,1,0,0,1,0
Aster Vranckx,BEL,MF,Wolfsburg,Bundesliga,21,2002,6.2,11,6,3,8,0,3,9,33.3,6,14,3,11,10,21,13,0
Stefan de Vrij,NED,DF,Inter,Serie A,32,1992,18.2,18,11,12,5,1,9,12,75,3,19,11,8,22,40,89,0
Ibrahima Wadji,SEN,"FW,MF",Saint-Étienne,Ligue 1,29,1995,3.9,7,6,3,3,1,3,7,42.9,4,1,0,1,1,8,0,0
Robert Wagner,GER,MF,St. Pauli,Bundesliga,21,2003,4.5,8,3,2,6,0,4,13,30.8,9,8,0,8,2,10,12,0
Elye Wahi,FRA,FW,Marseille,Ligue 1,21,2003,6.4,0,0,0,0,0,0,4,0,4,1,0,1,1,1,0,0
Elye Wahi,FRA,"FW,MF",Eint Frankfurt,Bundesliga,21,2003,2.2,0,0,0,0,0,0,1,0,1,1,0,1,0,0,1,0
Hauke Wahl,GER,DF,St. Pauli,Bundesliga,30,1994,33,36,27,21,13,2,23,38,60.5,15,44,25,19,31,67,170,4
Kyle Walker,ENG,DF,Manchester City,Premier League,34,1990,10.8,17,10,7,7,3,14,26,53.8,12,13,4,9,3,20,13,1
Kyle Walker,ENG,DF,Milan,Serie A,34,1990,7.3,17,9,12,4,1,13,17,76.5,4,9,5,4,9,26,15,1
Kyle Walker-Peters,ENG,DF,Southampton,Premier League,27,1997,32.4,44,29,22,15,7,16,35,45.7,19,27,15,12,19,63,90,1
Christian Walton,ENG,GK,Ipswich Town,Premier League,28,1995,7,0,0,0,0,0,0,1,0,1,0,0,0,0,0,2,1
Sebastian Walukiewicz,POL,DF,Torino,Serie A,24,2000,18.5,38,20,18,16,4,23,31,74.2,8,21,8,13,18,56,60,0
Sebastian Walukiewicz,POL,DF,Empoli,Serie A,24,2000,2,1,0,1,0,0,0,1,0,1,3,3,0,1,2,15,0
Aaron Wan-Bissaka,ENG,DF,West Ham,Premier League,26,1997,35,70,49,33,32,5,23,32,71.9,9,37,11,26,66,136,125,0
Paul Wanner,GER,"MF,FW",Heidenheim,Bundesliga,18,2005,19.7,40,27,16,21,3,15,32,46.9,17,15,0,15,4,44,20,0
Danny Ward,WAL,GK,Leicester City,Premier League,31,1993,1.5,0,0,0,0,0,0,0,,0,0,0,0,0,0,1,0
Joel Ward,ENG,DF,Crystal Palace,Premier League,34,1989,0.8,2,0,0,2,0,0,0,,0,0,0,0,0,2,3,0
James Ward-Prowse,ENG,MF,West Ham,Premier League,29,1994,11.5,20,14,8,8,4,7,19,36.8,12,6,3,3,8,28,15,0
James Ward-Prowse,ENG,MF,Nott'ham Forest,Premier League,29,1994,4.4,4,1,1,3,0,2,2,100,0,3,2,1,5,9,8,0
Kjell-Arik Wätjen,GER,MF,Dortmund,Bundesliga,18,2006,0.2,0,0,0,0,0,0,0,,0,0,0,0,0,0,2,0
Ollie Watkins,ENG,FW,Aston Villa,Premier League,28,1995,28.9,10,7,0,6,4,3,11,27.3,8,11,3,8,8,18,15,2
Timothy Weah,USA,"DF,FW",Juventus,Serie A,24,2000,18.2,36,19,15,13,8,14,25,56,11,25,4,21,14,50,27,2
Adam Webster,ENG,DF,Brighton,Premier League,29,1995,9.9,10,6,5,4,1,6,14,42.9,8,16,9,7,20,30,41,2
Julian Weigl,GER,MF,Gladbach,Bundesliga,28,1995,32,53,25,24,24,5,28,46,60.9,18,54,27,27,48,101,86,3
Timon Weiner,GER,GK,Holstein Kiel,Bundesliga,25,1999,25,0,0,0,0,0,0,1,0,1,0,0,0,0,0,17,3
Nelson Weiper,GER,"FW,MF",Mainz 05,Bundesliga,19,2005,7.8,5,4,2,3,0,2,4,50,2,5,0,5,2,7,5,1
Mitchell Weiser,GER,"DF,MF",Werder Bremen,Bundesliga,30,1994,31.9,61,40,19,34,8,28,56,50,28,33,3,30,22,83,61,3
Noah Weißhaupt,GER,"FW,MF",St. Pauli,Bundesliga,22,2001,12.9,6,4,3,0,3,3,8,37.5,5,7,0,7,2,8,8,1
Noah Weißhaupt,GER,FW,Freiburg,Bundesliga,22,2001,0.9,0,0,0,0,0,0,1,0,1,0,0,0,0,0,1,0
Danny Welbeck,ENG,FW,Brighton,Premier League,33,1990,23.5,26,16,6,15,5,8,20,40,12,19,4,15,5,31,14,0
Welington,BRA,DF,Southampton,Premier League,23,2001,5.4,21,9,15,5,1,12,19,63.2,7,5,1,4,7,28,36,0
Timo Werner,GER,"FW,MF",Tottenham,Premier League,28,1996,5.7,6,4,3,3,0,3,13,23.1,10,10,1,9,1,7,7,0
Adam Wharton,ENG,MF,Crystal Palace,Premier League,20,2004,14.6,34,14,14,16,4,17,44,38.6,27,11,2,9,20,54,27,0
Ben White,ENG,DF,Arsenal,Premier League,26,1997,13.3,20,14,10,4,6,16,38,42.1,22,10,8,2,16,36,44,0
Silvan Widmer,SUI,DF,Mainz 05,Bundesliga,31,1993,5.6,11,5,3,6,2,8,12,66.7,4,7,1,6,5,16,27,0
Mats Wieffer,NED,"DF,MF",Brighton,Premier League,24,1999,11.3,58,34,27,27,4,32,47,68.1,15,18,2,16,17,75,28,3
Mateusz Wieteska,POL,DF,Cagliari,Serie A,27,1997,2,1,0,0,1,0,1,1,100,0,3,2,1,7,8,6,0
Caleb Wiley,USA,"DF,MF",Strasbourg,Ligue 1,19,2004,3,1,0,0,1,0,0,1,0,1,3,1,2,4,5,5,0
Iñaki Williams,GHA,FW,Athletic Club,La Liga,30,1994,29.5,17,10,4,8,5,12,23,52.2,11,34,5,29,12,29,32,0
Neco Williams,WAL,DF,Nott'ham Forest,Premier League,23,2001,28.8,90,57,63,19,8,53,86,61.6,33,42,10,32,31,121,137,3
Nico Williams,ESP,FW,Athletic Club,La Liga,22,2002,22.2,28,18,10,11,7,11,32,34.4,21,20,1,19,7,35,9,0
Willian,BRA,"FW,MF",Fulham,Premier League,35,1988,2.9,4,2,0,3,1,2,6,33.3,4,0,0,0,1,5,1,0
Joe Willock,ENG,"MF,FW",Newcastle Utd,Premier League,24,1999,12.1,30,17,15,12,3,18,31,58.1,13,24,6,18,6,36,7,0
Callum Wilson,ENG,FW,Newcastle Utd,Premier League,32,1992,4.1,2,2,0,1,1,0,2,0,2,2,0,2,1,3,1,0
Harry Wilson,WAL,"FW,MF",Fulham,Premier League,27,1997,12.9,20,14,13,3,4,12,18,66.7,6,15,1,14,7,27,10,1
Patrick Wimmer,AUT,"MF,FW",Wolfsburg,Bundesliga,23,2001,19.7,47,35,19,21,7,15,46,32.6,31,31,4,27,32,79,15,2
Jonas Wind,DEN,"FW,MF",Wolfsburg,Bundesliga,25,1999,21.8,10,6,1,8,1,4,8,50,4,17,3,14,6,16,15,0
Harry Winks,ENG,MF,Leicester City,Premier League,28,1996,17.1,24,11,12,10,2,13,30,43.3,17,19,7,12,9,33,20,0
Ben Winterburn,ENG,"MF,FW",Bournemouth,Premier League,19,2004,0.3,0,0,0,0,0,0,1,0,1,0,0,0,2,2,0,0
Florian Wirtz,GER,"MF,FW",Leverkusen,Bundesliga,21,2003,26.1,32,20,10,12,10,9,22,40.9,13,32,3,29,10,42,6,1
Yoane Wissa,COD,FW,Brentford,Premier League,27,1996,32.4,22,12,6,8,8,11,27,40.7,16,29,8,21,8,30,21,3
Dani de Wit,NED,"MF,FW",Bochum,Bundesliga,26,1998,12.8,29,17,11,15,3,18,31,58.1,13,17,4,13,12,41,23,1
Axel Witsel,BEL,DF,Atlético Madrid,La Liga,35,1989,9.5,16,12,4,10,2,12,14,85.7,2,15,8,7,11,27,34,1
Maximilian Wittek,GER,DF,Bochum,Bundesliga,28,1995,30.1,65,42,40,19,6,38,54,70.4,16,54,8,46,27,92,89,3
Marius Wolf,GER,DF,Augsburg,Bundesliga,29,1995,23.8,27,16,13,11,3,16,43,37.2,27,29,5,24,24,51,51,1
Nick Woltemade,GER,"FW,MF",Stuttgart,Bundesliga,22,2002,18,10,7,2,4,4,6,10,60,4,23,2,21,1,11,15,1
Jeong Woo-yeong,KOR,"MF,FW",Union Berlin,Bundesliga,24,1999,14,10,7,5,5,0,3,11,27.3,8,10,1,9,11,21,11,0
Chris Wood,NZL,FW,Nott'ham Forest,Premier League,32,1991,32.9,6,5,2,2,2,3,11,27.3,8,12,7,5,5,11,29,1
Nathan Wood-Gordon,ENG,DF,Southampton,Premier League,22,2002,8.6,14,8,8,5,1,8,11,72.7,3,9,6,3,5,19,39,2
Christopher Wooh,CMR,DF,Rennes,Ligue 1,22,2001,16.2,36,19,21,13,2,18,27,66.7,9,22,8,14,23,59,63,0
Luke Woolfenden,ENG,DF,Ipswich Town,Premier League,25,1998,13.2,9,6,5,4,0,2,5,40,3,21,14,7,19,28,76,0
Granit Xhaka,SUI,MF,Leverkusen,Bundesliga,31,1992,32.1,48,26,15,27,6,24,42,57.1,18,30,7,23,12,60,52,6
Lamine Yamal,ESP,FW,Barcelona,La Liga,17,2007,31.7,42,28,8,17,17,16,38,42.1,22,12,0,12,16,58,3,0
Daniel Yáñez,ESP,FW,Real Madrid,La Liga,17,2007,0,0,0,0,0,0,0,0,,0,0,0,0,0,0,0,0
Erencan Yardimci,TUR,"FW,MF",Hoffenheim,Bundesliga,22,2002,3.5,4,3,1,3,0,1,2,50,1,2,0,2,1,5,2,0
Yehor Yarmoliuk,UKR,MF,Brentford,Premier League,20,2004,16.1,49,28,21,21,7,28,55,50.9,27,26,9,17,13,62,33,0
Ryan Yates,ENG,MF,Nott'ham Forest,Premier League,26,1997,21.3,42,21,24,14,4,17,37,45.9,20,38,10,28,26,68,61,1
John Yeboah,ECU,"FW,MF",Venezia,Serie A,24,2000,13.6,6,3,1,3,2,1,10,10,9,4,0,4,4,10,2,0
Bertuğ Yıldırım,TUR,FW,Getafe,La Liga,22,2002,12,10,5,0,7,3,2,7,28.6,5,13,2,11,1,11,16,0
Kenan Yıldız,TUR,"FW,MF",Juventus,Serie A,19,2005,26.7,54,30,13,26,15,18,32,56.3,14,25,0,25,5,59,13,3
Leny Yoro,FRA,DF,Manchester Utd,Premier League,18,2005,12.9,29,11,19,9,1,13,19,68.4,6,5,3,2,18,47,43,0
Ashley Young,ENG,DF,Everton,Premier League,39,1985,20.8,58,33,25,25,8,35,57,61.4,22,14,4,10,25,83,64,2
Etienne Youte Kinkoue,FRA,DF,Le Havre,Ligue 1,22,2002,25.8,19,10,11,7,1,13,20,65,7,36,23,13,29,48,158,3
Illia Zabarnyi,UKR,DF,Bournemouth,Premier League,21,2002,34.5,52,36,31,20,1,34,50,68,16,33,20,13,41,93,182,2
Eloge Zabi,CIV,"DF,MF",Reims,Ligue 1,17,2006,0.2,0,0,0,0,0,0,0,,0,0,0,0,0,0,1,0
Mattia Zaccagni,ITA,FW,Lazio,Serie A,29,1995,29.8,38,27,13,21,4,16,32,50,16,19,1,18,29,67,22,2
Dan-Axel Zagadou,FRA,"DF,MF",Stuttgart,Bundesliga,25,1999,0.3,0,0,0,0,0,0,0,,0,0,0,0,1,1,1,0
Yoram Zague,FRA,"DF,FW",Paris S-G,Ligue 1,18,2006,2,8,6,3,1,4,6,8,75,2,3,0,3,2,10,2,0
Wilfried Zaha,CIV,FW,Lyon,Ligue 1,31,1992,0.8,1,1,1,0,0,1,2,50,1,3,0,3,1,2,0,0
Warren Zaïre-Emery,FRA,"MF,DF",Paris S-G,Ligue 1,18,2006,22.8,51,26,17,21,13,23,45,51.1,22,35,6,29,23,74,20,2
Miha Zajc,SVN,MF,Toulouse,Ligue 1,30,1994,2.9,4,4,1,2,1,3,5,60,2,2,1,1,3,7,7,0
Denis Zakaria,SUI,MF,Monaco,Ligue 1,27,1996,23.8,41,26,15,19,7,24,33,72.7,9,31,8,23,34,75,39,1
Arsen Zakharyan,RUS,"MF,FW",Real Sociedad,La Liga,21,2003,0.8,1,1,1,0,0,1,1,100,0,1,1,0,1,2,0,0
Nicola Zalewski,POL,"DF,FW",Roma,Serie A,22,2002,5.9,8,6,3,2,3,2,7,28.6,5,7,2,5,4,12,8,2
Nicola Zalewski,POL,"DF,MF",Inter,Serie A,22,2002,4.8,7,4,3,2,2,4,6,66.7,2,5,1,4,2,9,5,1
Andre-Frank Zambo Anguissa,CMR,MF,Napoli,Serie A,28,1995,31.7,42,26,8,28,6,15,34,44.1,19,24,6,18,35,77,40,1
Francesco Zampano,ITA,DF,Venezia,Serie A,30,1993,18.2,31,20,19,10,2,14,31,45.2,17,21,1,20,6,37,29,2
Nicolò Zaniolo,ITA,FW,Fiorentina,Serie A,25,1999,3.8,3,1,1,2,0,0,4,0,4,2,1,1,0,3,2,0
Nicolò Zaniolo,ITA,"FW,MF",Atalanta,Serie A,25,1999,4,0,0,0,0,0,0,2,0,2,0,0,0,1,1,0,0
Alessandro Zanoli,ITA,"FW,DF",Genoa,Serie A,23,2000,19,29,20,11,14,4,10,23,43.5,13,20,3,17,12,41,40,0
Duván Zapata,COL,FW,Torino,Serie A,33,1991,6.5,7,5,2,0,5,0,3,0,3,2,1,1,2,9,7,0
Gabriele Zappa,ITA,DF,Cagliari,Serie A,24,1999,34,40,23,20,17,3,17,34,50,17,42,22,20,23,63,93,1
Davide Zappacosta,ITA,DF,Atalanta,Serie A,32,1992,23,26,16,15,5,6,20,39,51.3,19,28,6,22,11,37,32,2
Bryan Zaragoza,ESP,"FW,MF",Osasuna,La Liga,23,2001,20.4,13,9,8,4,1,6,21,28.6,15,10,0,10,4,17,8,0
Anass Zaroury,MAR,"FW,MF",Lens,Ligue 1,23,2000,15.6,23,17,6,12,5,9,26,34.6,17,9,0,9,6,29,15,0
Oier Zarraga,ESP,MF,Udinese,Serie A,25,1999,10,19,13,7,10,2,10,22,45.5,12,9,5,4,2,21,8,0
David Zec,SVN,DF,Holstein Kiel,Bundesliga,24,2000,17.1,23,10,17,6,0,13,20,65,7,32,18,14,17,40,93,3
Jordan Zemura,ZIM,DF,Udinese,Serie A,24,1999,15.7,31,14,14,12,5,17,29,58.6,12,17,4,13,16,47,41,0
Robin Zentner,GER,GK,Mainz 05,Bundesliga,29,1994,32,2,1,2,0,0,1,2,50,1,0,0,0,0,2,31,4
Alessio Zerbin,ITA,DF,Venezia,Serie A,25,1999,16.9,51,28,30,12,9,29,52,55.8,23,28,3,25,15,66,25,1
Alessio Zerbin,ITA,"FW,DF",Napoli,Serie A,25,1999,0,2,1,2,0,0,1,1,100,0,0,0,0,0,2,0,0
Kevin Zeroli,ITA,MF,Monza,Serie A,19,2005,4.4,6,2,3,3,0,0,1,0,1,6,1,5,2,8,11,0
Kevin Zeroli,ITA,MF,Milan,Serie A,19,2005,0.1,1,1,0,1,0,0,0,,0,0,0,0,0,1,0,0
Cedric Zesiger,SUI,DF,Augsburg,Bundesliga,26,1998,13.6,13,7,7,6,0,8,13,61.5,5,17,10,7,21,34,96,1
Cedric Zesiger,SUI,DF,Wolfsburg,Bundesliga,26,1998,5.8,13,8,6,5,2,6,12,50,6,6,5,1,3,16,28,0
Michael Zetterer,GER,GK,Werder Bremen,Bundesliga,29,1995,34,0,0,0,0,0,0,1,0,1,1,0,1,1,1,10,7
Nathan Zeze,FRA,DF,Nantes,Ligue 1,19,2005,16.8,38,22,22,16,0,23,33,69.7,10,22,9,13,23,61,120,1
Edon Zhegrova,KVX,"FW,MF",Lille,Ligue 1,25,1999,10.9,5,2,3,0,2,2,7,28.6,5,8,0,8,4,9,1,0
Piotr Zieliński,POL,MF,Inter,Serie A,30,1994,10.9,14,10,6,7,1,6,13,46.2,7,10,5,5,6,20,13,1
Oleksandr Zinchenko,UKR,"DF,MF",Arsenal,Premier League,27,1996,5.9,6,1,1,3,2,3,8,37.5,5,8,1,7,5,11,10,0
Melvin Zinga,FRA,GK,Angers,Ligue 1,22,2002,1,0,0,0,0,0,0,0,,0,0,0,0,0,0,1,0
Joshua Zirkzee,NED,"FW,MF",Manchester Utd,Premier League,23,2001,15.6,14,8,3,8,3,5,10,50,5,15,4,11,6,20,8,1
Budu Zivzivadze,GEO,FW,Heidenheim,Bundesliga,30,1994,10.6,17,11,1,9,7,4,8,50,4,9,0,9,3,20,7,0
Luck Zogbé,CIV,DF,Brest,Ligue 1,19,2005,7.1,32,18,17,11,4,18,26,69.2,8,11,2,9,14,46,22,1
Nadir Zortea,ITA,"DF,MF",Cagliari,Serie A,25,1999,30.1,30,14,16,12,2,14,37,37.8,23,11,0,11,19,49,47,2
Aristide Zossou,CIV,MF,Auxerre,Ligue 1,19,2005,0.2,0,0,0,0,0,0,0,,0,0,0,0,0,0,0,0
Yanis Zouaoui,ALG,"DF,FW",Le Havre,Ligue 1,30,1994,10.8,20,10,10,8,2,11,15,73.3,4,15,2,13,8,28,43,0
Igor Zubeldia,ESP,DF,Real Sociedad,La Liga,27,1997,25.2,34,22,21,10,3,14,26,53.8,12,32,18,14,31,65,100,2
Martín Zubimendi,ESP,MF,Real Sociedad,La Liga,25,1999,32.9,73,37,31,29,13,28,44,63.6,16,42,16,26,44,117,79,3
Edhy Zuliani,FRA,DF,Toulouse,Ligue 1,19,2004,0.1,0,0,0,0,0,0,0,,0,0,0,0,1,1,0,0
Szymon Żurkowski,POL,MF,Empoli,Serie A,26,1997,1.2,6,4,2,4,0,4,4,100,0,3,0,3,1,7,2,0
Martin Ødegaard,NOR,MF,Arsenal,Premier League,25,1998,25.8,19,11,9,7,3,4,25,16,21,5,0,5,6,25,6,1
Milan Đurić,BIH,FW,Monza,Serie A,34,1990,14.1,1,1,0,1,0,0,3,0,3,6,0,6,2,3,17,0
Milan Đurić,BIH,FW,Parma,Serie A,34,1990,3,0,0,0,0,0,0,2,0,2,3,0,3,0,0,2,0
